			
ولادیمیر زلنسکی، رییسجمهوری اوکراین با اشاره به شواهد ماهوارهای،	ولادیمیر زلنسکی، رییسجمهوری اوکراین با اشاره به شواهد ماهوارهای، از دخالت کره شمالی در جنگ روسیه با اوکراین، خواهان واکنش شدید نسبت به این موضوع شده استگفتوگو با علیرضا محبی، ایراناینترنشنال		
شهروندی با ارسال ویدیویی به ایراناینترنشنال فاکتور کالاهای مورد ن	شهروندی با ارسال ویدیویی به ایراناینترنشنال فاکتور کالاهای مورد نیاز خریداریشده را نشان میدهد و با اشاره به هزینه آن خطاب به سران جمهوری اسلامی میگوید خدا لعنتتان کند با پول مردم ایران موشک و بمب میسازید و بر سر زن و بچه مردم میریزید انشاالله بعد از نصرالله نوبت شماها باشد		
دادستانی تهران از برخورد با شماری از موسسات اعزام دانشجویان به خا	دادستانی تهران از برخورد با شماری از موسسات اعزام دانشجویان به خارج از کشور خبر دادمعاون حقوق عامه دادستان تهران دادستانی مراکز غیرمجاز را شناسایی و پلمپ میکند گفتوگو با امید معماریان، روزنامهنگار و تحلیلگر سیاسی		
بیش از ۵۰۰ روزنامهنگار، هنرمند و فعال اجتماعی در نامهای از رییس ق	بیش از ۵۰۰ روزنامهنگار، هنرمند و فعال اجتماعی در نامهای از رییس قوه قضائیه خواستهاند با استفاده از اختیارات خود، اجرای حکم نیلوفر حامدی و الهه محمدی را متوقف کند پیشتر وکلای آنها از اجرای حکم پنج سال حبس خبر داده بودندگفتوگو با آزاده دواچی، فعال حقوق بشر و زنان		
زهرا بهروز آذر، معاون امور زنان در دولت پزشکیان درباره ابلاغ حکم	زهرا بهروز آذر، معاون امور زنان در دولت پزشکیان درباره ابلاغ حکم پنج سال زندان به الهه محمدی و نیلوفر حامدی به روزنامه هممیهن گفت موضوع این دو خانم خبرنگار از چند مسیر در حال پیگیری است، و معاونت امور زنان و خانواده هم به سهم خود پیگیر است		
ویدیوهای دریافتشده نشان میدهند جمعی از شرکتکنندگان آزمون کیفیتبخش	ویدیوهای دریافتشده نشان میدهند جمعی از شرکتکنندگان آزمون کیفیتبخشی آموزش و پرورش که دارای کارنامه سبز هستند روز یکشنبه ۲۹ مهرماه در اعتراض به عدم پاسخگویی به مطالباتشان از سراسر ایران در تهران حاضر شده و مقابل مجلس، سازمان بازرسی کشور و وزارت آموزش و پرورش تجمع برگزار کردندکارنامه سبزها داوطلبان استخدامی هستند که در مصاحبه پس از آزمون رد شده و در اعتراضاتی خواستار استخدام شدهاند		
درباره ایران	تلویزیول الحره متق ولت آمریکا ، ب یک مقام وللپای الائیلی د ایوگوگوگوگوگوگوگ کشاله خلیج ف ظ الائیرائیل ای و از حمله الائیل وه مواضو دور وریه خو ه و شورای		
سرخط خبرها، دوشنبه ۳۰ مهر	سرخط خبرها، دوشنبه ۳۰ مهر		
پادشاه چارلز و همسرش ملکه کامیلا روز دوشنبه وارد کانبرا پایتخت اس	پا چارلز و ملکه کامیلا وز دوش کاورا پایخ الالیا ش ای هفوه ی ور پاه چارز از لیا و اولی و وه ای کشور از ز پاشاه ش او د ۲۰۲۲ ا گزالی ی،		
گزارش داد دونالد ترامپ، رییسجم هوری پیشی	گزارش داد دونالد ترامپ، رییسجم هوری پیشین آمریکا، اکنون شانس بیشتری برای پیروزی در انتخابات ریاستج است		
دیدار رهبران ترکیه و آلمان اردوغان اسرائیل به دنبال گسترش جنگ در	دیدار رهبران ترکیه و آلمان اردوغان اسرائیل به دنبال گسترش جنگ در من طقه مبارزه با حماس و حزبالله قوانین للی را رعایت کند گزارش نرگس هورخش، ایران اینترنشنال		
ویدیوها و تصاویر ارسالشده به ایراناینترنشنال نشان میدهند جمعی از	ویدیوها و تصاویر ارسالشده به ایراناینترنشنال نشان میدهند جمعی از نسرین ۱۴۰۱ ، در میدان مللستمن تورنتو تجمع برگزار کردندحاضران خواهان آزادی دیگر شیرپیشه، ماشالله کرمی، منوچهر بختیاری، رضا سلمانزاده و کمال لطفی دند		
نامزد به شبکه ال	نامزد به شبکه العربیه گفت با محمد بن سلمان، ولیعهد عربستان سعودی، براز گرداندن صلح به منطقه همکاری خواهد کرد		
ات روز ی	مهرماه الباتشان تجمع اعتراضی برگزار کرده و شعارهایی چون نوبت ما که میشه،		
ویدیوی منتشرشده در شبکههای اجتماعی حاکی از سوختن شعبهای از موسسه	ویوی مش د شوهای اج حاکی از ز ش ش از مو القورض الح از پا ی اقای ، ب ح مالی د کرده است		
شبکه عربی الحره، که متعلق به دولت آمریکاست، در گزارشی به نقل از ی	شبکه عربی الحره، که متعلق به دولت آمریکاست، در گزارشی به نقل از یک م نبع اسرائیلی نوشت کشورهای عرب خلیج فارس در پیامهایی به اسرائیل با د قاطع و روشن باشد		
ر ایالت پ	دولا ترامپ، ریی پیشی آمریکا ، ب یکی ز ش شی ی مکووو دالت پ لوا ا و وهطو ششر گر ی میی سرخک آماده کردای ام ج جمهوریخوا ااخا آ واکشی و اظهارات رقی کامال ب گ در دورا دالشجویی در مکدونالد کار میکرده استترامپ که پیشتر گفته بود هریس هرگز در مکدو نکرده، روز یکشنبه گفت حالا من ۱۵ دقیقه بیشتر از کامالا در دونالد کارکردهام		
آیدا شاکرمی، خواهر نیکا شاکرمی، خبر داد که مادرشان، نسرین شاکرمی	آیدا شاکرمی، خواهر نیکا شاکرمی، خبر داد که مادرشان، نسرین شاکرمی م منوعالتماس و ممنوعالملاقات است		
مراد ویسی، ایران اینترنشنال بهنظر میرسد چینیها آرام آرام در حال آ	مراد ویسی، ایران اینترنشنال بهنظر میرسد چینیها آرام آرام در حال آم		
ویدیوی منتشرشده در رسانههای اجتماعی حاکی از سوختن جنگلها و مراتع	ویدیوی منتشرشده در رسانههای اجتماعی حاکی از سوختن جنگلها و مراتع م نطقه چمباغ و حیاتالغیب از توابع شهرستان دوره چگنی در استان لرستان شامگاه یکشنبه ۲۹ مهرماه است		
مراد ویسی، ایراناینترنشنال اطلاعات فوق محرمانه آمریکا ن شان میده	مراد ویسی، ایراناینترنشنال اطلاعات فوق محرمانه آمریکا ن شان میدهد نیروی هوایی اسرائيل در روزهای گذشته در حال تمرین به جمهوری اسلامی بوده		
جمهوری اسلامی و اسرائیل دارند خودشان را برای سطح بالاتری از درگیر	جمهوری اسلامی و اسرائیل دارند خودشان را برای سطح بالاتری از درگیری و جنگ آماده میکنند		
سیاست با مراد ویسی ۲۹ مهر ۱۴۰۳ ۲۰ اکتبر	سیاست با مراد ویسی ۲۹ مهر ۱۴۰۳ ۲۰ اکتبرنسخه صوتی برنامه سیاست با مر		
گسترده ارتش اسرائیل به مواضع اقتصادی حزبالله در لبنان گفتوگو با ح	حملات گسترده ارتش اسرائیل به مواضع اقتصادی حزبالله در لبنانگفتوگو با حسن هاشمیان، تحلیلگر جهان عرب		
			
درباره ایران	تلویزیول الحره متق ولت آمریکا ، ب یک مقام وللپای الائیلی د ایوگوگوگوگوگوگوگ کشاله خلیج ف ظ الائیرائیل ای و از حمله الائیل وه مواضو دور وریه خو ه و شورای		
سرخط خبرها، دوشنبه ۳۰ مهر	سرخط خبرها، دوشنبه ۳۰ مهر		
پادشاه چارلز و همسرش ملکه کامیلا روز دوشنبه وارد کانبرا پایتخت اس	پا چارلز و ملکه کامیلا وز دوش کاورا پایخ الالیا ش ای هفوه ی ور پاه چارز از لیا و اولی و وه ای کشور از ز پاشاه ش او د ۲۰۲۲ ا گزالی ی،		
گزارش داد دونالد ترامپ، رییسجم هوری پیشی	گزارش داد دونالد ترامپ، رییسجم هوری پیشین آمریکا، اکنون شانس بیشتری برای پیروزی در انتخابات ریاستج است		
دیدار رهبران ترکیه و آلمان اردوغان اسرائیل به دنبال گسترش جنگ در	دیدار رهبران ترکیه و آلمان اردوغان اسرائیل به دنبال گسترش جنگ در من طقه مبارزه با حماس و حزبالله قوانین للی را رعایت کند گزارش نرگس هورخش، ایران اینترنشنال		
ویدیوها و تصاویر ارسالشده به ایراناینترنشنال نشان میدهند جمعی از	ویدیوها و تصاویر ارسالشده به ایراناینترنشنال نشان میدهند جمعی از نسرین ۱۴۰۱ ، در میدان مللستمن تورنتو تجمع برگزار کردندحاضران خواهان آزادی دیگر شیرپیشه، ماشالله کرمی، منوچهر بختیاری، رضا سلمانزاده و کمال لطفی دند		
نامزد به شبکه ال	نامزد به شبکه العربیه گفت با محمد بن سلمان، ولیعهد عربستان سعودی، براز گرداندن صلح به منطقه همکاری خواهد کرد		
ونتشرشده در شبکههای اجتماعی نشان میدهند بازنشستگان ات روز ی	مهرماه الباتشان تجمع اعتراضی برگزار کرده و شعارهایی چون نوبت ما که میشه،		
ویدیوی منتشرشده در شبکههای اجتماعی حاکی از سوختن شعبهای از موسسه	ویوی مش د شوهای اج حاکی از ز ش ش از مو القورض الح از پا ی اقای ، ب ح مالی د کرده است		
شبکه عربی الحره، که متعلق به دولت آمریکاست، در گزارشی به نقل از ی	شبکه عربی الحره، که متعلق به دولت آمریکاست، در گزارشی به نقل از یک م نبع اسرائیلی نوشت کشورهای عرب خلیج فارس در پیامهایی به اسرائیل با ایت از حمله این کشور به جمهوری اسلامی تاکید کردهاند پاسخ اسرائیل بای د قاطع و روشن باشد		
نیشین ر ایالت پ	دووو ترامپ، ریی پیشی آمریک ، ب یکی یکی ز شز مکووو دالت پ لوا ا رت وهطور مش میی سرخک آماده کردای ام ج جمهوریخوا ااخا آ واکشی و اظهارات رقی کامال ب گ در دورا دالشجویی در مکدونالد کار میکرده استترامپ که پیشتر گفته بود هریس هرگز در مکدو نالد کار نکرده، روز گفت حالا من ۱۵ دقیقه بیشتر از کامالا در دونالد کارکردهام		
آیدا شاکرمی، خواهر نیکا شاکرمی، خبر داد که مادرشان، نسرین شاکرمی	آیدا شاکرمی، خواهر نیکا شاکرمی، خبر داد که مادرشان، نسرین شاکرمی م منوعالتماس و ممنوعالملاقات است		
مراد ویسی، ایران اینترنشنال بهنظر میرسد چینیها آرام آرام در حال آ	مراد ویسی، ایران اینترنشنال بهنظر میرسد چینیها آرام آرام در حال آم		
ویدیوی منتشرشده در رسانههای اجتماعی حاکی از سوختن جنگلها و مراتع	ویدیوی منتشرشده در رسانههای اجتماعی حاکی از سوختن جنگلها و مراتع م نطقه چمباغ و حیاتالغیب از توابع شهرستان دوره چگنی در استان لرستان شامگاه یکشنبه ۲۹ مهرماه است		
مراد ویسی، ایراناینترنشنال اطلاعات فوق محرمانه آمریکا ن شان میده	مراد ویسی، ایراناینترنشنال اطلاعات فوق محرمانه آمریکا ن شان میدهد نیروی هوایی اسرائيل در روزهای گذشته در حال تمرین به جمهوری اسلامی بوده		
جمهوری اسلامی و اسرائیل دارند خودشان را برای سطح بالاتری از درگیر	جمهوری اسلامی و اسرائیل دارند خودشان را برای سطح بالاتری از درگیری و جنگ آماده میکنند		
سیاست با مراد ویسی ۲۹ مهر ۱۴۰۳ ۲۰ اکتبر	سیاست با مراد ویسی ۲۹ مهر ۱۴۰۳ ۲۰ اکتبرنسخه صوتی برنامه سیاست با مر		
حملات گسترده ارتش اسرائیل به مواضع اقتصادی حزبالله در لبنان گفتوگ	حملات گسترده ارتش اسرائیل به مواضع اقتصادی حزبالله در لبنانگفتوگو با حسن هاشمیان، تحلیلگر جهان عرب		
			
برای محافظت ا	ر ی الائیل گزارش داد   ساوشکی ماد الائیل مح از کشور کشور  حمله احمالی جم ی ل ولیای ری الش الوه      وش که وری ای  د در کار		
ترامپ به العربیه گفت نتانیاهو در پاسخ به جمهوری اسلامی کاری ر	ترامپ به العربیه گفت نتانیاهو در پاسخ به جمهوری اسلامی کاری را که م      م دهد		
دونالد ترامپ به شبکه العربیه گفت ایرانیان باهوش هستند و در حال	دونالد ترامپ به شبکه العربیه گفت ایرانیان باهوش هستند و در حال حاضر رش را میکردند که این خیلی بد است اسلامی انتقاد کرد		
جامعه مدرسین ح	معه مدرسین حوزه علمیه قم، با اشاره به نبود شور و حضور سابق بین طلاب، گفت چه شد که متن حوزه خلوت شده است او افزود حوزه		
سیانان آمریکا اسناد محرمانه نظامی که در کانال تلگرامی منتشر	سیانان آمریکا اسناد محرمانه نظامی که در کانال تلگرامی منتشر شد ه است را بررسی میکندگفتوگو با مرضیه حسینی، ایراناینترنشنال		
گزارش رسانههای لبنانی حاکی از وقوع حملات هوایی در بیروت است،	بیه نوشت این حملات منطقه ضاحیه را هدف قرار داده استاین گزارشها پس		
یک منبع ارشد اطلاعاتی اسرائیل به خبرنگاران گفت تا حدود یک ما	یک منبع ارشد اطلاعاتی اسرائیل به خبرنگاران گفت تا حدود یک ماه پیش، ودجهای از ایران دریافت میکردند این بودجه طی ماههای گذشته بهموقع میرسید اما طی چند هفته اخیر، چند تغییراتی رخ داده است اکنون، آنها نمیتوانند بهراحتی بودجه دریافت کنند و هزینههایشان به دلایل مختلف، از جمله افزایش تعداد نیروها و خرید سلاحهای بیشتر، بهشدت بالا رفته استاین مقام اطلاعاتی ارشد اسرائیل گفت واقعیت اقتصادی حزبالله این است که هر ماه حدود ۵۰ میلیون دلار    شاره کرد بخشی از این پول به صورت دلارهای فیزیکی است قسمتی از آن از طریق یک توافق نفتی منتقل میشود ایراو ف را و خود از طریق فروگ ا ولال ی وروت چچچ ی ی حلاوی ورا تا ی زی ز الله القال		
بوده که با وجود	احمد علمالهدی، نماینده خامنهای در خراسان رضوی گفت کدام کشور بو ده که با وجود مشکلاتی که جامعه ما داشته تا این اندازه رشد کرده و پ ای خود ایستاده باشداو افزود روبهرو شدن با تهاجمهای مختلف دشمن وجب افسردگی نمیشود، بلکه نشاطآور است		
یجی دارد گفت	ی داردگفتوگو با شکریا برادوست، پژوهشگر امنیت بینالملل و سیاست خ ارجی		
کانال یازده تلویزیون اسرائیل به نقل از یک مقام این کشور اعلامک	کالال یازلویزیوووو اسرائیل وه ولقل از یک مقام ایور ا  کرد ک ئی بملهای   وه وراود آمیش   الائیل از ق د ا  ای  پال ای حمله ر د ، بورای آ آماگی ویژ ی در ایوی زمینه وجود دارد		
چشمانداز ۲۹ مهر  ۱۴۰۳ ۲۰ اکتبر	چشمانداز ۲۹ مهر  ۱۴۰۳ ۲۰ اکتبرنسخه صوتی برنامه چشمانداز		
ه پایگاههای ا	دالیل هاری، خوی الش ا خوا  کورد چگ ایرال ا ا فاده از و و اج غیر غیامی وشش،وشش، فوشش، فوشش، ف  ی زو ز        د		
نوید طوبیان، پژوهشگر ارشد ایران ایالات متحده آمریکا خود را صد	نوید طوبیان، پژوهشگر ارشد ایران ایالات متحده آمریکا خود را صد در ص د متعهد به دفاع از اسرائیل میداند		
د گفتوگو با م	فتوگو با محمد قائدی، مدرس روابط بینالملل در دانشگاه جورج واشین گتن		
ر در ساعات آیند	یک منبع ارشد اطلاعاتی اسرائیل به ایران اینترنشنال گفت که این کشور د ر ساعات آینده، حملات دقیق و گستردهای را در سراسر لبنان انجام خواهد داد که سیستم اقتصادی حزبالله و پایگاههای اقتصادی این گروه راف قرار میدهدبه گفته او، هدف از این حملات، ضربه زدن به توانایی حزبالله برای فعالیت در طول جنگ و همچنین بعد از مجدد سازمانی استاین منبع اسرائیلی گفت داریم به نفوذ حزبالله بر بخشهای وسیعی از جامعه لبنان، بهویژه معه شیعه، ضربه بزنیمسخنگوی ارتش    حزبالله قرار دارند هشدار داد از این اماکن دور شوند او گفت ارتش اسرائیل به زودی به منابع تامین مالی حزبالله حمله خواه دکرد		
مسعود پزشکیان در سخنرانی امروز از تلاش برای پنهان کردن مشکلات	کردنی گفت، و از بدهکاری دولت، و ناترازی در بانکها و صندوقهای بازنشستگی		
انتشار اسناد محرمانه درباره حمله تلافیجویانه اسرائیل به ایران	ران		
ی بزرگ شبکهها	ومح ، ، م م کی رص میکوم او ازود  صاح ک ک ک و کاره کر ای ش ش  تیغاتاشاش و الا ذک داد   ود ود در مراحل بعدی برخورد متناسی خواهد شد		
ویدیوی منتشرشده در خبرگزاری فرانسه نشان میدهد طرفداران کامالا	ویوی   در د فرگزار فرا   طرفاوم کامالا  خ الخ الخ ای ا  کلیی ی  الوو ایالت جورجیا ورای او ت تولد  خوالد ه ه ۶۰ ک ک ک ک ک ک ک ک ک ک ک ک ک ک ک ز زز ا ج ی ال		
حسین نوری همدانی، مرجع تقلید شیعه گفت حوزه علمیه قم باید پاس	حسین نوری همدانی، مرجع تقلید شیعه گفت حوزه علمیه قم باید پاسخگوی ج هان اسلام به خصوص تشیع باشد و بدانیم چشمهای فراوانی به این مرکز کرد و ت چه شدکه متن حوزه خلوت شده است		
گو با اشکان صفا	تازهترین خبرها از حمله احتمالی اسرائیل به جمهوری اسلامیگفتوگو با اشکان صفایی، ایراناینترنشنال		
سطین و لبنان،	ر و ی وا  ا اشاره بوه کمپی ایای طلای زوه فل و  ،  ،  ، ن ک زوریزی، وریزی، ور دو خور خ خ ا  د		
گفتوگوی ویژه مصطفی علوش، نماینده پیشین پارلمان لبنان نسخه ک ا	گفتوگوی ویژه با مصطفی علوش، نماینده پیشین پارلمان لبناننسخه کامل		
کورهای باستانی در شهر جینگدژن چین دوباره احیا و به عنوان بخ ش	کورهای باستانی در شهر جینگدژن چین دوباره احیا شده و به عنوان بخشی کار میرود		
ویدیوها و گزارشهای منتشرشده در خبرگزاری فرانسه حاکی است که مظ	طراحی حمله به سفارت اسرائیل در آلمان بازداشت شده استبه گفته دفتر دا دستانی عمومی فدرال، عمر ع، شهروند لیبیایی شامگاه شنبه در برنائو در ن زدیکی برلین دستگیر شده است    ئیل در برلین انجام دهد		
مسعود پزشکیان سیاستهای تحمیلی مجلس، از جمله دلایل بحرانهای	مسعود پزشکیان سیاستهای تحمیلی مجلس، از جمله دلایل بحرانهای اقت		
احمد بخشایش اردستانی، عضو کمیسیون امنیت ملی گفت مواضعی که با	احمد بخشایش اردستانی، عضو کمیسیون امنیت ملی گفت مواضعی که دن و نتانیاهو در خصوص حمله اسرائیل به ایران میگیرند، بیشتر جنگ تبل یغاتی و روانی استاو افزود ما پیشتر در دو مرحله به دو کشور دارای بم ب اتم حمله کردهایم		
گواردیولا با هدایت سیتیزنها با پیروزی دو بر یک برابر ولور	ایرال ایشورزشیگوالیوول وهدای ی پیوزی بورا ولوره ،ولا ی ی در لیگ و ک پیش از ای وا وا ب در فاصله آوریل ۲۰۱۷ ژاوی ۲۰۱۸ورده ود ، ارقا وه		
ویدیوی منتشرشده از سوی ارتش اسرائیل، اقامتگاه مخفی و زیر زمینی	ویدیوی منتشرشده از سوی ارتش اسرائیل، اقامتگاه مخفی و زیر زمینی یحی ی سنوار، رهبر کشتهشده حماس را در غزه نشان میدهد که با میلیونها لار پول رها شده است		
ه اسراییل برای	براساس دو سند خیلی محرمانه نهادهای اطلاعاتی آمریکا درباره برنامه اسراییل برای حمله به ایران که به یک کانال تلگرامی نزدیک به جمهوری اسلامی درز کرده، اسرائیل در روزهای اخیر مشغول یک تمرین نظامی بزرگ و انتقال ۵۶ موشک بالستیک پیشرفته هوا به زمین بودهگزارشی از مجتبا پورمحسن		
هواداران تیم فولاد خوزستان که در این فصل با یحیی گلمحمدی	ایرال ایشورزشیهو فم فولاد خ خر ی  ی گل گلمی قا ک ک و شال   صر جول را داولد ، ز ش باب آل آلومیوم اراک هش لیگ و پایکوبی پرداختندویدیو ورزش سه		
روزنامه اعتماد در یادداشتی با انتقاد از حمله امیر قلعهنوی	ایرال ایشورزشیروزوزوزا ا ی یاد ا ا ا  ق قلویی، سول    ه  و و و  و و  ب د ق ش رزوم ی  ۹۲ و و و و آ وه مد يازه هيچ جامی ش ش ش  ااد ی یاداش تاکی یول قلویی ز پ یال تاریخ ایراو ،        سی فوت  ف ت يی زير د ش داش زاز حاظظ مالی غنی بودند        از متقاعد كردن منتقدان و رسانهها بردارد و كار خودش را پيش ببرد اگر نتيجه حاصل شود همه آن نتيجه را میبينند و غرضورزیها خدشها ی به تيم ملی وارد نمیكند اگر نتيجه حاصل نشود هم كه هيچ توجيهی كارساز نيست در اين ميان مخصوصا از كادرفنی تيم ملی میخواهيم از دستاوردسازی دور ی كنند		
غلامعلی حداد عادل، عضو مجمع تشخیص مصلحت نظام گفت غرب امروز ه	غلامعلی حداد عادل، عضو مجمع تشخیص مصلحت نظام گفت غرب امروز همان غر ب استعمارگر و جهانخوار گذشته است و هیچ نغییری نکرده است		
در اعتراض به صدور حکم اعدام برای سه زندانی سیاسی خوزستان، تجمع	بل کنسولگری جمهوری اسلامی در لندن برگزار شدگفتوگو با وجدان عفراوی ، تحلیلگر مسائل ایران و جهان عرب		
معاون وزیر علوم از ابعاد برخورد امنیتی با دانشجویان معترض در ج	معاون وزیر علوم از ابعاد برخورد امنیتی با دانشجویان معترض در جریان خیزش زن، زندگی، آزادی گزارش استجزئیات بیشتر در گفتوگو با رحیمپور، تحلیلگر سیاسی		
فرشاد ابراهیمپور، عضو کمیسیون آموزش مجلس، درباره آمار پنهان ک	فرشاد ابراهیمپور، عضو کمیسیون آموزش مجلس، درباره آمار پنهان کودک ان بازمانده از تحصیل به سایت دیدهبان ایران گفت امسال حدود ۲ میلیون دانشآموز ثبتنام نشدهانداو افزود اقتصادی باعث شده تا		
نتانیاهو در گفتوگو با ترامپ اسرائیل بر اساس منافع خود تصمیم	نتانیاهو در گفتوگو با ترامپ اسرائیل بر اساس منافع خود تصمیم میگ محرما ترنشنال از گفتوگوی ترامپ و نتانیاهو میگوید		
محمدرضا احمدی، نماینده رشت در مجلس گفت ما تا آخر ایستادهایم	محرضا احمی،   شر   جا آخا آخا آخایاداد و و از فل   ح و ک رز ج  جاومتاوم ق  ق                            ا پیروزی  ق خ خواهیم داد   در وه خود وه ی ویال پویا هستیم		
ر، تنها ۱۰ درصد	خبرگزاری تسنیم در گزارشی از وضعیت دریاچه ارومیه نوشت در حال حاضر، مانده و تراز آن به ۱۲۷۰ متر و ۱۰ لیترین عوامل خشک شدن		
سکینه پروانه، زندانی سیاسی در نامهای از اوین با اشاره به تکرا	سکینه پروانه، زندانی سیاسی در نامهای از اوین با اشاره به تکرار واژه کودککش برای اسرائیل از سوی رسانهها در ایران، گفت عدم مسئولیتپذیری و سکوت در مواجهه با کودککشی جمهوری اسلامی، در حافظه تاریخی ما میماندگفتوگو با رضا اکوانیان، روزنامهنگار و فعالحقوق بشر		
جلیل ناصری، ملیپوش دو صحرانوردی ایران، پس از اعلام فدراسی	، پس از اعلام فدراسیون دوومیدانی مبنی بر اعزامنکردن ورزشکاران این رشته به مسابقات قهرمانی آسیا در هنگکنگ، از ورزش قهرمانی خداحافظی رد و به ایسنا گفت یک گونی مدال مختلف دارم اما شبها نگهبانی میدهم و روزها جوشکاری میکنمقهرمان دو صحرانوردی ن دراینباره گفته ۱۵ سال است که برای دوومیدانی زجر میکشم، الان شغ ل و درآمدی ندارم و مجبورم کارگری کنم باچه امیدی ادامه بدهم به چه دردم میخورد که دوومیدانی را پنج سال دیگر هم ادامه بدهم از زندگی عقب میافتم کارگری کنم از ورزش و این بیتوجهی بهتر است من تازه ازدواج کردهام اما بخاطر نداشتن شغل و درآمد زندگیام در حا ل از هم پاشیدن است کاش زودتر ورزش را کنار میگذاشتمناصری با توضیح این که ده بار بر ای استخدام رفته اما جواب رد شنیده، گفت یعنی این همه مدال آسیایی ارزش نداشت که من را سر کار ببرند وزارت ورزش، فدراسیون دوومیدانی، استانداری و فرمانداری رفتم و نامه هم بردم  جزئیات بیشتر را اینجا بخوانید		
تیم فوتبال اینترمیامی بامداد امروز و پس از پیروزی شش بر دو	ایرال  ریک لیوول   آ آ آ دوت فوت ، ا ب جام ق  صل ول ی لیگ  را ک کا  ج به تیمی اهدا میشود که بیشترین امتیاز را در فصل کسب کند و میزبان آمریکا در جام جهانی باشگاههای ۲۰۲۵ این مسابقات خواهد بود و بازی افتتاحیه را در ورزشگاه ۶۵ هزار نفری ها		
علیرضا بیرانوند، گلر تراکتور که روز گذشته از سوی کمیته انض	ایرال ایشورزشی وورزشی گلرر ت تو گذش ز س ک ک ک ا لیل ا ،و و  و و  اذیو ا  انو   اتهام دریاف وه و هیات میره پ ، دو  یارد توم ش ، یک الوری   میگوی حلت را  را  را  را  را  راا را  را  را  را  را  را   ر		
ویدیوهای منتشرشده در رسانههای لحظه برخورد امواج بزرگ دریا را	ویدیوهای منتشرشده در رسانههای اجتماعی، لحظه برخورد امواج بزرگ در یا را به شهر سنمالو فرانسه در شامگاه شنبه ۲۸ مهرماه نشان میدهد		
خویشتنداری مق اومت به پایان ر	مقاوم ت به پایان رسیده و هرکه در پرونده اسرائیلی ها دخیل باشد، تادیب خواه د شد و با آنها برخورد میشوداو افزود در رویکرد جدید مقاومت، آمر، عامل و تجهیزکننده همه با هم شریک هستند		
ستار رحمانی، فعال کارگری از خواستههای بازنشستگان در اعتراضات	می گوید		
در نهمین سال پذیرش و اجرای توافق هستهای، روزنامه همشهری، اتحا	در نهمین سال پذیرش و اجرای توافق هستهای، روزنامه همشهری، اتحادیه اروپا را به طفره رفتن از ادامه کردمهران کارشناس روابط بینالملل از مهمترین مفاد اجرایی برجام و دلایل شکست آن میگوید		
انیا، کامالا هری	ا، کامالا هریس را بدترین معاون رییسجمهور و جو بایدن را ناتوان ذهنی  خطاب کرد		
مسعود پزشکیان، رئیسجمهور ایران امروز و در همایش روز ملی صادرا	مسعود پزشکیان، رئیسجمهور ایران امروز و در همایش روز ملی صادرات، د رباره وضع نابسامان و جنگی اقتصاد کشور ابراز نگرانی کردگفتوگو م رتضی کاظمیان، ایران اینترنشنال		
سرخط خبرهای یکشنبه ۲۹ مهر	سرخط خبرهای یکشنبه ۲۹ مهر		
دونالد ترامپ نتانیاهو به من گفت به حرف بایدن گوش نمیکند چون	دونالد ترامپ نتانیاهو به من گفت به حرف بایدن گوش نمیکند چون اگر ا ین کار را میکرد، نمیتوانست به موفقیتی دست یابداشکان صفایی، ایرا ن اینترنشنال گزارش میدهد		
علی لاریجانی، رییس پیشین مجلس و مشاور علی خامنهای گفت کشوره	علی لاریجانی، رییس پیشین مجلس و مشاور علی خامنهای گفت کشورهای عر  کشورهای عربی که به دنبال بیانیهنویسی علیه ایران درباره جزایر سهگ هستند به موقع به حساب آنها باید رسید		
امیرحسین بانکیپور، عضو کمیسیون فرهنگی گفت لایحه حجاب و ع فا	امیرحسین بانکیپور، عضو کمیسیون فرهنگی گفت لایحه حجاب و عفاف یعنی برخورد هوشمندانه با برهنگی و آنچیزی که باعث شده برهنگی وارد جا معه نشود، الزامی بودن حجاب استاو افزود چنانچه حجاب برود ما مثل بسی اری از کشورها وارد ورطه برهنگی میشویم		
ارتش اسرائیل ویدیوی جدیدی از لحظه هدف قرار دادن خانهای را منت	الش الائیل ویوی ججی از لظ د قرار خاله ا    کرد  ک س وار دروو آ   ، ح ، ،وز  ۲۵ مه  در تلالطال رف در ووار غز  ش  یک وز وز آوه  پی ورد		
عوامل انتظامی و عوامل اجرایی یگان حفاظت محیط زیست شاهرود در یک	عوامل انتظامی و عوامل اجرایی یگان حفاظت محیط زیست شاهرود در یکی از منازل این شهر حیوانات تاکسیدرمی شدهای راکشف و ضبط کردنددر اینز ل همچنین بقایای پلنگ ایرانی، کل و قوچ و تعدادی پرنده وحشی هم یافت شده است		
ارت اسرائیل د	دادستانی آلمان اعلام کرد یک پناهجوی اهل لیبی را که قصد حمله به سفار ت اسرائیل در برلین را داشته بازداشت کرده است مرد ۲۸ ساله که در کمپ پناهجویان در برلین زندگی میکند بهاری رنشنال		
گاهشمار  یک سال درگیری اسرائیل و حزبالله پس از ۷ اکتبر	گاهشمار  یک سال درگیری اسرائیل و حزبالله پس از ۷ اکتبر		
نوشابه امیری چه سوالی از خامنهای میپرسد یکی از مخاطبان برن	نوشابه امیری چه سوالی از خامنهای میپرسد یکی از مخاطبان برنامه با کامبیز حسینی از نوشابه امیری روزنامهنگا گفتوگو کند چه سوالی از او میپرسد پاسخ او را ببینیم		
فت حدود یکسو	گروه بهبود تغذیه معاونت بهداشت اصفهان گفت حدود یکسوم دانشآموزان استان دچار سوءتغذیه هستند و این اختلال در آنها رو به افزایش استاو افزود بد غذا خوردن هم نوعی سوءتغذیه است که شامل چاقی و اضافه وزن هم میشود		
بررسی روزنامههای امروز ایران، یکشنبه، ۲۹ مهر			
علی شیرازی، ایران اینترنشنال دانشگاه آزاد، بدون اطلاعرسانی ق	علی شیرازی، ایران اینترنشنال دانشگاه آزاد، بدون اطلاعرسانی قبلی شده است		
حسین دهقان، رییس بنیاد مستضعفانگفت بنیاد مستضعفان یک مجموعه	حسین دهقان، رییس بنیاد مستضعفان گفت بنیاد مستضعفان یک مجموعه اقتص ادی است و نمیتوان انتظار داشت که یک مجموعه اقتصادی به دنبال سود نبا شداو افزود در هر مجموعه اقتصادی زیان و هم سود طبیعی است و در بنیاد ه م شرکتهای زیان ده وجود دارد		
نیمرخ  رابرت فرانسیس کندی جونیور، فرزند یکی از برجستهترین خ	نیمرخ  رابرت فرانسیس کندی جونیور، فرزند یکی از برجستهترین خانوا ری آمریکا شرکت کرده بود در آگوست ۲۰۲۴، او با حمایت از دونالد ترامپ از انتخابات کنارهگیری کرد اقدامی که به عقیده کارشناسان موجب فاصلهگیری او از مسیر خانوادگی اش شد		
در پی افزایش احتمال حمله اسرائیل، قیمت دلار آمریکا در بازار آز	در پی افزایش احتمال حمله اسرائیل، قیمت دلار آمریکا در بازار آزاد ته ۷۰۰ تومان افزایش یافته استرضا غیبی، روزنامهنگار اقتصادی از لایل اصلی این افزایش شدید قیمتها در بازار سکه و ارز میگوید		
مسعود پزشکیان، رییسجمهور جمهوریاسلامی از وضع نابسامان و جنگ	د پزشکیال ، ریی ج جمهو وض وض وض  و جو جو ج اد الا وراز ورالی ک فگگوگو  آرش آز		
نوشابه امیری انقلاب ۵۷ از سوی عوامل خارجی سازماندهی شده بود	نوشابه امیری انقلاب ۵۷ از سوی عوامل خارجی سازماندهی شده بود نوشا به امیری روزنامهنگار و گوینده در برنامه با کامبیز حسینی در پاسخ به یکی از مخاطبان برنامه میگوید انقلاب ۵۷ انقلابی واقعی نبوده، بلکه ا ز سوی عوامل خارجی سازماندهی شده بود		
گروهی از جوانان فیلیپینی روز یکشنبه ۲۹ مهرماه در یک مرکز خرید	گروهی از جوال یلیپیی  یکش ۲۹ ۲۹ م م م م  خری در مو م ج تا وه مرگ پی ،والد ش     گروه واو دای ادای احرام ک ، ،  چ م م پ از وط وط ب بات م ط ط سوم هتلی در بوئنوس آیرس آرژانتین درگذشت		
های علوم پزشکی	محمد قربانی، سخنگوی دانشگاه آزاد در واکنش به افزایش شهریه رشتهها ی علوم پزشکی دانشگاه آزاد گفت برای کیفیت خوب آموزش لازم بود شهریه رشتههای علوم پزشکی افزایش پیدا کنداو افزود فقط ۵ تا ۶ درصد از دان شجویان به شرایط شهریه اعتراض دارند		
سایت خبری اسرائیلی وای نت اسرائیل از نقاط قوت حزله لبنان که د	سایت خبری اسرائیلی وای نت اسرائیل از نقاط قوت حزبالله لبنانکه در جنگ سوریه از آن بهره میبرد، به عنوان نقطه ضعف استفاده میکندگفت وگو با اشکان صفایی، ایراناینترنشنال		
اسرائیل با انتشار ویدیویی اعلام کرده به مقر اطلاعاتی حزبا لله	ه در بیروت حمله هوایی کرده است		
سایت ارم نیوز مستقر در امارات به نقل از یک منبع ایرانی نوشت که	استور مقامات ارشد جمهوری ز ترس کشته شدن توسط اسرائیل با هواپیمای عباس عراقچی، وزیر خارجه ایرا ن، به تهران رفته استنعیم قاسم از زمان کشته شدن حسن نصرالله سه سخنرانی داشته استاین سایت به نقل از این منبع نوشت که سخنرانی های دوم و سوم او از تهران پخش شدهاندعباس		
گوید	وید		
ٔیل هشدار داد و	ا  ا خی  خوا د داد م کاظ ، ایرال ایتت  ، ص ص ی امو ج  جمهوری الامی بوو		
ر واژه کودککش	سکینه پروانه، زندانی سیاسی محبوس در زندان اوین، با اشاره به تکرار و نادی و عدم مسئولیتپذیری و سکوت در مواجهه با کودککشی جمهوری    سوی هر حکومتی محکوم است		
مسعود پزشکیان روز یکشنبه ۲۹ مهرماه در مراسم روز ملی صادرات خطا	مسعود پزشکیان روز یکشنبه ۲۹ مهرماه در مراسم روز ملی صادرات خطاب به صادرکنندگان گفت با ما جلسه بگذاریم تا مشکلات را برطرف کنیم آن یکی جلساتی که میگذاریم تشریفاتی است و وقت تلف میکنیم خبر میگوییم و خبر میشنویم		
اولاف شولتز، صدر اعظم آلمان در دیدار با رجب طیب اردوغان بریتا	ا شولز، صر ال آل آلما ی طی اردوغاوغاوغاوغاوغالیا فروش احمالی ججج یو ترکیه را گوگوگوگ  گ خش، ایراایووو		
و ستاد اطلاعات	الش الائیل از چد حمله جو وروت از جمله اووو ی تیات و و اطلا ز دالل  ک   حملات ب مواض دالله دوو ل  ، ، ، اح  ، یی گ تولی تیاییاسیاسیاسی کشت ه شدند		
تاریخ شفاهی  در این قسمت، باقر پرهام جامعه شناس و مترجم خاطرا	تاریخ شفاهی  در این قسمت، باقر پرهام جامعه شناس و مترجم خاطراتی از چریکهای فدایی خلق میگوید    ی به سوی جنگ مسلحانه علیه پهلوی دوم میپردازدشنبه، ۱۹۳۰ به وقت ته ران		
مسعود پزشکیان، در مراسم روز ملی صادرات گفت دشمنان ما را در و	مسعود پزشکیان، در مراسم روز ملی صادرات گفت دشمنان ما را در وضعیتی ق  او افزود ما در حال جنگیم، جنگی که بر ما تحمیل شده و روزبهروز نیز بدتر میشود		
محمدحسن اختری، رییس کمیته حمایت از انقلاب اسلامی فلسطینگفت	مح اخری، ریی کمی  از القلا فللا گگطی شش مقاومت ولت ول روز در  ولا  فرو خواهد رت ازود ج ج الامی د و در هر می ک  ولاز ش ، آنچه را که تشخیص میدهد در دفاع و حمایت از مقاومت انجام خواهد داد		
ویدیوی منتشرشده از سوی ارتش اسرائیلگوشههایی از عملیات زمینی	گوشههایی از عملیات زمینی ای نارتش را در غزه و در نبرد با نیروهای حماس نشان میدهد		
رکیب اردوغان، رییسجمهوری ترکیه و اولاف شولتز، صدر اعظم آلم ان	طی  ، ریی ج و او ولاف صولز، صوم آ  ک ک ک کول ال  شام ش توق ج ولطق قراری آ آ		
حسین آقایی، پژوهشگر امور استراتژیک و روابط بینالملل درباره در	حسین آقایی، پژوهشگر امور استراتژیک و روابط بینالملل درباره درز ک ردن جزئیاتی از اسناد محرمانه حمله نظامی اسرائیل به جمهوریاسلامی ابینه اسرائیل میدانست که در یک سناریوی بدبینانه ممکن است اسنادی که با آمریکا در میان میگذارد، به بیرون درز کند		
شمارش  هزینه کارزارهای انتخاباتی در امریکا تاثیر کمک مالی به	شمارش  هزینه کارزارهای انتخاباتی در امریکاتاثیر کمک مالی به کاندید اها در انتخابات آمریکا چقدر است کاندیدایی که بیشتر هزینه میکند همیشه برنده میشود در این قسمت از شمارش به این موضوع میپردازیم		
آزاد تهران به	پی پی ازایش تش  جمهوری الامی و الائیل قی دلار ب بار آزاد از ۶۴ ز هزار ۳۰۰ومال یافو قی  ه  قط  تمام ط		
که منجر به کشته	فایی، ایراناینترنشنال		
ویدیوها و گزارشهای منتشرشده در رویترز حاکی است روز یکشنبه ۲۹	ویدیوها و گزارشهای منتشرشده در رویترز حاکی است روز یکشنبه ۲۹ مهرم    ار گرفته است		
ویدیوی منتشرشده در خبرگزاری فرانسه، رهگیری راکتهای شلیکشده ا	نشا ن میدهد		
علی شیرازی، ایراناینترنشنال جمهوریاسلامی با وجود انکار دست	شیرازی، ایرالایش جمهوریالا وجود اود ار داش دمل  مل     ب  توو بور  ا فاده از ز الله ل  ود		
عباس عراقچی، وزیر خارجه جمهوری اسلامی، در مصاحبه با انتیوی ت	شابه علیه ایران را دریافت خواهد کرداو افزود ما اکنون برای حمله مشا به همه اهداف خود را شناسایی کردهایم		
منوعیت برگزاری	محود کمره  آموزشی داوزشیاه تهراو ، الاغ ولا  م ک ک ک ک  در م ق ق  تلی  دالا  داد و گ ا صرفا کلا آ آمیلی، ج و غیرا میواورگزار ک ازود ما کلا یور وری نداریم		
یک کانال تلگر	اد محر   ش  د  حمله  الائیوه ایرال ک کاولگ وال وه بمهو شر شام   و القال  ، رزمایش  وی هوی الائیل و اساد ز موشک ی بمی ای  الوگو و رالوز  گار		
ولودیمیر زلنسکی، رییسجمهور اوکراین، در یک سخنرانی گفت سرباز	ولویمیر زلل رییل  اوک ، گورالی گ  کرهشی که ب ی   اوک یج ، اول  ج ی خواهد ود  ازود ایرال پیش از ی پ و و وه وه رو داد  ، ا طور و رسمی		
محمدباقر قالیباف، رییس مجلس، درباره سفر اخیرش به لبنان گفت ه	محمدباقر قالیباف، رییس مجلس، درباره سفر اخیرش به لبنان گفت همه م ا سرباز ایران هستیم و تاثیرگذاری گسترده این حضور در بیروت به دلیل و یژگیهای شخصی نیست بلکه به پشتوانه مسئولیتی استکه در نظام مقدس جم هوری اسلامی داریم		
مایش گذاشت جای	موزه تیت لندن آثار چهار هنرمند فینالیست جایزه ترنر امسال را به نمای ش گذاشت جایز  یکی از م جوایز هوومی جهاوه ح   یآی ب  ویلیام توو ، ش و یک هوری وریا اهدا میشوگزارش کیمیا ق ی، ایرالایش		
شهروندی با ارسال ویدیویی به ایراناینترنشنالگوشهای تخریبش ده	ش ی  ا  ویویی وه ایرالایش گوشوش خ خ  جال جلی ید داغی     شهر روده زیارک جولی و ک جاده اصلی را ت  و و و و  خوشاوش ق  و نداده باشند		
سخنگوی ارتش اسرائیل ما فیلمی مربوط چند ساعت قبل از کشتار هفت	سخنگوی ارتش اسرائیل ما فیلمی مربوط چند ساعت قبل از کشتار هفتم اکتب ر را که یحیی سنوار سالها برای آن برنامهریزی کرد، منتشر کردیم وانوادهاش را در شبکههای زیرزمینی حماس، در وضعیت لاکچری مخفی میکرد و خودش، پولهایش و تروریستهایش را بر مردم غزه ترجیح م یداد		
شهروندے مد علمالهدی و	علمالهدی و لایحه شورای نگهبان درباره حجاب اجباری واکنش داده می  هر چقدر دلتان میخواهد قانون تصویب کنید، زنان با حجاب اختیاری رفتوآ مد کنند و دیگر نمیتوانید حجاب اجباری را به زور سرشانکنید		
با افزایش درگیریها در خاورمیانه، ترکیه قصد دارد در سال ۲۰۲۵ م	با افزایش درگیریها در خاورمیانه، ترکیه قصد دارد در سال ۲۰۲۵ مبلغ ۴۷ میلیارد دلار را به بخشهای دفاعی و امنیتی خود اختصاص دهد  اینترنشنال		
سیانان و آکسیوس گزارش دادند افشای اسناد محرمانه اطلاعاتی آم	او آک گزارش داد اشاس ا محر ی واشیگ و آغاز ت و و ای الا د ز ز ش  شوگوگوگوگوگوگوگ    ، روز		
شهروندی با ارسال ویدیویی به ایراناینترنشنالگوشهای تخریبش ده	ش ی  ا  ویویی وه ایرالایش گوشوش خ خ  جال جلی ید داغی     شهر روده زیارک جولی و ک جاداد اصلی رراش دا و و یوشوش ک کردها دا  ود ک اگی   او نداده باشند		
سرخط خبرهای یکشنبه ۲۹ مهر	سرخط خبرهای یکشنبه ۲۹ مهر		
یک میلیون دلار	ایلان ماسک به امضاکنندگان طومار حمایت از متمم قانون اساسی روزی یک میلیون دلار اهدا میکندایلان ماسک گردهمایی در پنسیلوانیا انتخابات آمریکا، به رایدهندگان ثبتن اساسی    ک میلیون دلار اهدا خواهد کردماسک در همین گردهمایی با معرفی یکی از ضران به عنوان اولین برنده این جایزه، او را غافلگیر کرد		
یکا درباره طرح ا	او آک گزارش داد اشاس ا محر  واشیگ و آغاز ت و و ایالا د ز ز شه الش    ول  از ساه گزارش آ د حا ح ل وری الاد بسیار محرمانهای درباره حمله اسرائیل به ایران است که در یک کانال ت لگرامی وابسته به جمهوری اسلامی منتشر شدهاند یکی از این منابع، اعتبار این اسناد را تایید کرده است یک مقام آمریک  یا گ آ در حال ت و  ا متوج کود ی کوه ای پوو د  قا آمریکایی گ چ ش اطلا ی ومیشود تات ا اتاگووو  اط ل جزییات چگونگی آماده شدن اسرائیل برای این حمله، از جمله نقل و انتق ال مهمات، رزمایش نیروی هوایی اسرائیل و استفاده از موشکهای هوا به زمین در این مانورها و نیز مهیا		
ویدیوهای ارسالشده به ایراناینترنشنال نشان میدهند جمعی از یر	ویدیوهای ارسالشده به ایراناینترنشنال نشان میدهند جمعی از ایر انیان مقیم آلمان روز شنبه ۲۸ مهرماه علیه جمهوری اسلامی تجمع اعتراض ی برگزار کرده و بهمناسب کشته شدن یحیی سنوار، رهبر حماس، شیرینی پخش کردند		
وری اسلامی در رد	یسرائیل کاتس، وزیر خارجه اسرائیل، با اشاره به موضع مقامهای جمهور ی اسلامی در رد نقش حکومت ایران در حمله به اقامتگاه نتانیاهو و نسبت دا ن یروی نیابتی و پای اختاپوسی که جمهوری الا ی آ وه وجود آورد ، تامی و تی کرده ،موزش داد  آرا هم ک یش ک  ، ول وه وووا یک موجوی    دروغها و نمایشهای کذبتان به شما کمکی نمیکند و شما مسئول این وض عیت هستید		
شبکه ۱۲ اسرائیل به نقل از یک مقام دولتی ایران پشت حمله به اقا	شبکه ۱۲ اسرائیل به نقل از یک مقام دولتی ایران پشت حمله به اقامتگاه ند بالستیک تاد خبر داد وزیر انرژی اسرائیل همه گزینهها از جمله حمله به تاسیسات هستهای ایران روی میز استگزارش اشکان صفایی ، ایران اینترنشنال		
جیهفت در ناپل	سفر صدراعظم آلمان به ترکیه همزمان با نشست وزرای دفاع کشورهای عضو جی هفت در ناپل ایتالیاگزارش احمد صمدی، ایران اینترنشنال		
ویدیوی ارسالشده به ایراناینترنشنال نشان میدهد جمعی از ایرا	ویوی الالش  وه ایرا ایت ول     ی د از ایاو  قیم شوز روز  ج ش ز زگی آزای  یز جمهوری الامی ش شهر تورکو جم کرد		
ویدیو و تصاویر منتشرشده در رسانههای اجتماعی نشان میدهند رو	ویو  صاوی د ر  ی ایماومی  روز ش ۲۸ مالشجوی  پزشکی، ی پزشکی،پزشکی و د دازی  ض ازایش ۲۰۰ درص ش   مقال مجل تر ج جگزار کردوه ی پ پت و پیرا  شا زایشایشه ش د		
مراد ویسی، ایراناینترنشنال قطعی بودن حمله اسرائیل و همراه ب	مراد وی ایرالایتشال قط  ح الائیل  وراه  ی جمهوری الامی کای با اوضاوض ا در ود		
مراد ویسی، ایراناینترنشنال واقعیت این است که جمهوری اسلامی ا	مراد ویسی، ایراناینترنشنال واقعیت این است که جمهوری اسلامی از سر ترس دارد تهدید به جنگ منطقهای می کند		
تلاش ناکام سپاه و نیابتیها برای کشتن نتانیاهو			
سیاست با مراد ویسی  ۲۸ مهر  ۱۴۰۳ ۱۹ اکتبر	سیاست با مراد ویسی  ۲۸ مهر  ۱۴۰۳ ۱۹ اکتبرنسخه صوتی برنامه سیاست با مراد ویسی تلاش ناکام سپاه و نیابتیها برای کشتن نتانیاهو		
تیم فوتبال رئال مادرید در هفته دهم لالیگا با نتیجه دو بر ی	گا با نتیجه دو بر یک سلتاویگو را شکست داد کیلیان امباپه و وینیسیوس، گلهای رئال را زدندگل پیروزیبخش شاگ ردان کارلو آنچلوتی را لوکا مودریچ که امشب رکورد مسنترین بازیکن تار		
باشگاه استقلال اعلام کرد با اینکه پیتسو موسیمانه و دستیارا	ایرال ایشورزشی وورزشی ا ا  الام کورد با ایک  پی  د و د در الدو  ا ا   وخیاریز ب وا ال  آ خ خواهد ود  ال واقوا     را    پس از پایان بازی، کادرفنی جدید به همراه بازیکنان و سایر اعضای کادرف نی به تهران بازخواهند گشت تا فعالیت رسمی خود را با استقلال در تهران آ غاز کنند		
تلاش دولت و مردم مجارستان برای حفظ بناهای تاریخی بوداپست مهران	تلاش دولت و مردم مجارستان برای حفظ بناهای تاریخی بوداپستمهران عباس یان، ایران اینترنشنال گزارش میدهد		
یکا شاکرمی، نوش	شازاد رضا پهلوی پ   ا  فوری و بدون قید و شرط شاکرمی شد و نوشت بانو نسرین، شیرزنی که نیکای د لیر ایران را پرورش داد، پس از قتل فرزند جاویدنامش، چون سروی آزاد در ب رابر رژیم ایستاد و دروغهای صداوسیمای ضدملی را افشا کرد رژیم الگر دل تلاش  شاک		
یوسف طباطبایینژاد، نماینده خامنهای در اصفهان گفت دامداری و	کشا ورزی برای کشور اهمیت بالایی دارند و باید با در قبال این موارد مدارا ک  ار بز کوهی وجود دارد		
اه بنیامین نتا	بنیامین نتانیاهو گفت تلاش جمهوری اسلامی برای ترور نتانیاهو با شاخه لبنانیاش، عبور از خط قرمز است بهایی که ایران خواهد پرداخت در کتابهای تاریخ حک خواهد شد پایان رژیم ظالم ایران نزدیکتر از همیشه است		
ارتش اسرائیل ویدیویی منتشر کرده که یحیی سنوار و خانوادهاش را	ارتش اسرائیل ویدیویی منتشر کرده که یحیی سنوار و خانوادهاش را در ح ال فرار، داخل تونل محل اختفایشان در شب قبل از حمله هفتم اکتبر حماس به نشان میدهددانیل هاگاری، سخنگوی ارتش اسرائیل در یک کنفران س مطبوعاتی درباره این ویدیو گفت چند ساعت قبل از قتل عام هفتم اکتبر سنوار و خانوادهاش به تنهایی به تونل فرا ر کردند آ  ورام ا ی طولا ،ود ود ود ، آ ، و  خ خ ، تلویزیوو و ق از ققل ووام ، ب بک خود و و خاواد بود ، ک  توری ورای الجا حملهای وحشیانه فرستاده بود		
سخنگوی دفتر نمایندگی جمهوری اسلامی در سازمان ملل ارتباط تهران	دوی دومایگی جمهوری الامی در زماو ا اط ط  ب  پ پ و اقامگاه   اتالیال  ووال ا  ژ ژور گ ای اقام از  س س زالله للا الجام ش		
دانیال هاگاری، سخنگوی ارتش اسرائیل سنوار سالها برای حمله ۷ ا	هاگاری، سخنگوی ارتش اسرائیل سنوار سالها برای حمله ۷ برنامهریزی کرده بود		
ویدیوهای منتشرشده در رسانههای اجتماعی، لحظه حمله روز شنبه اسر	اجتماعی، لحظه روز شنبه اسرائی ل را به خودروی حامل معصومه کرباسی و رضا عباس عواضه، زوج ایرانیلبنان ی، در منطقه جونیه در شمال بیروت نشان میدهد که در پی این حمله خود را از دست دادند		
شهر لیون فرانسه	الا  ، و ای ۵۰ س سالهاش گ زمالی کار خودم را ش کلد یلم ی زی ی  ودم ف   او ا  افزود هر رنجی شایسته توجه است تا تلاشها برای متوقف کردن آن انجام شود		
منشه امیر، کارشناس امور خاورمیانه با تلاش جمهوری اسلامی برای	منشه امیر، کارشناس امور خاورمیانه با تلاش جمهوری اسلامی برای ترور نتانیاهو، اسرائیل این مشروعیت را پیدا کرده که نه تنها مواضع سپاه را هدف قرار دهد بلکه میتواند به افراد کلیدی رژیم هم آسیب برساند  به ایران دارد		
محسن سازگارا، تحلیلگر سیاسی گفته میشود سردار فلاحزاده که جا	سازگارا، تحلیلگر سیاسی گفته میشود سردار فلاحزاده که جانشی ن سپاه قدس است، حزبالله را مستقیما رهبری میکند و حملات پهپادی جدی د به اسرائیل که هفته گذشته هم چهار سرباز اسرائیلی را کشت، توسط سپاه ه دایت میشوند و سپاه مستقیما کنترل حملات حزبالله به اسرائیل را برعهده گرفته		
رسانههای عربی روز شنبه گزارش دادند که در پی حمله پهپادی اسرائ	ر ی  وز شوز ش گزارش دادل ک پی ح پ پ الائیوه یکودر شوهر شوه د د یروت ش   کو کرول و   ل او وه وه     عواضه کش  شد		
چشمانداز ۲۸ مهر  ۱۴۰۳ ۱۹ اکتبر	چشمانداز ۲۸ مهر  ۱۴۰۳ ۱۹ اکتبرنسخه صوتی برنامه چشمانداش سپاه برای ترور نتانیاهو اسرائیل چه میکند		
حمله پهپادی به خانه نتانیاهو آیا جمهوری اسلامی وارد سطح جدیدی	حمله پهپادی به خانه نتانیاهو آیا جمهوری اسلامی وارد سطح جدیدی از ج نگ با اسرائیل شده استگفتوگو با هوشنگ حسنیاری، تحلیلگر مسائل نظا می		
ت فرستادگان	نوشت خانواده او را ترور کنند، بار دیگر چهره واقعی حکومت ایران و محور شرار		
تلاش سپاه برای ترور نتانیاهو اسرائيل چه میکند	تلاش سپاه برای ترور نتانیاهو اسرائيل چه میکند		
واد غذایی و پزشک	ویدیوهایی غذایی و پزشکی در همکاری بین اسرائیل و ۱۳ کشور جهان، از هواپیماها روی غزه فرود آمد		
بنیامین نتانیاهو، نخستوزیر اسرائیل، در واکنش به حمله پهپادی ب	یامی ،  وزیوزی روز قص ترور وور و  را داشد ، مرکو اش  ورگی شد این اقدام من و اسرائیل را از ادامه جنگ به منظور تضمین امنیتمان باز نخواهد داشت		
واشینگتن پست احتمال پیروزی ترامپ در سایت شرطبندی پالی مارکت	واشیگول پ احمال پیوزی ترامپ در ی شرطی پالی مارک اافه الگوگوگوگوگوگوگوگوگوگوگوگوگوگوگوگوگوگوگوگوگوگوگوگوگوگوگ		
محمدجواد ظریف، معاون راهبردی پزشکیان، گفت به مردم خیلی بدهک	محمجواد ظ م م راه پزشکیال ، گ گ گ گ گ گ گ   خیلی د  مردم برای مشکلات راهحلها دارند، مشکلات را میدانند و باید طرف شورت ما باشند او افزود نباید منتظر دستور تهران باشیم دستور از مردم میرسد آنها هستند که ما را سرپا نگه داشتهاند		
اناینترنشنال	درخواست سوئد برای تروریستی شناختن سپاهگزارش مهران عباسیان، ایران اینترنشنال		
	نشست وزرای گروه هفتگفتوگو با کیمیا قربانی، ایراناینترنشنال		
	نشست وزرای گروه هفتگفتوگو با کیمیا قربانی، ایراناینترنشنال		
اشکان صفایان اینترنشنال حزبالله لبنان تا کنون مسئولیت مله به	اشکان صفایی، ایران اینترنشنال حزبالله لبنان تا کنون مسئولیت حمل ه به خانه نتانیاهو را بر عهده نگرفته است		
سنوار نوشت که س	روزوز جوال ، وال   پال  ، طل در  ی ی س که که کوار  وه دوو ، ا یاح ا یاح اح میروودای روز  اشاره پرتا		
در این قسمت از برنامه تاریخ شفاهی، نیره ابتهاج سمیعی، از اولین	در این قسمت از برنامه تاریخ شفاهی، نیره ابتهاج سمیعی، از اولین نمای  یکند او همچنین از وضعیت نمایندگان مجلس شورای ملی در ماههای پس از پیروز ی انقلاب در سال ۱۳۵۷ میگویدنسخه کامل برنامه را در یوتیوب تماشا کنی د		
ارتش اسرائیل روز شنبه ۲۸ مهرماه از کشف و انهدام یک تونلکلیدی ح	ارتش اسرائیل روز شنبه ۲۸ مهرماه از کشف و انهدام یک تونل کلیدی حزبا لله در جنوب لبنان خبر داد در این گذرگاه زیرزمینی یک مرکز فرماندهی، یک انبار تسلیحات و چند اتا استف اده میکردند		
ویدیوهای منتشرشده از سوی ارتش اسرائیل، بخشی از عملیات زمینی ای	ویدیوهای منتشرشده از سوی ارتش اسرائیل، بخشی از عملیات زمینی این ار تش را در جنوب لبنان از دید دوربینهای نصب میدهد		
ر تلاش است با اف	لاش است با افسانهپردازی ازو چهره یک قرمان بسازد    شی از مجتبا پورمحسن		
مقامهای ارشد طالبان، از جمله رییسالوزرا و رییس دادگاه عالی،	مقامهای ارشد طالبان، از جمله رییسالوزرا و رییس دادگاه عالی، پس از کشته شدن یحیی سنوار، رهبر حماس، پیامهای تسلیت جداگانهای ارسال  د  اکنش مشابهی نشان داد که گروه شیعی حزبالله بود، کاملا سکوت اختیار کردند		
آرش حسننیا، روزنامهنگار اقتصادی با وجود اینکه همه به نقش تح	آرش حیا ، زوزوزگگار اقای  وجود ایک    قش تری بوز فلاک اق ای اصولگر د   داخلی، خ پ داری د  یاهمی جلوه داد آ		
کشتهشدن یحیی سنوار، چه تاثیری بر رفتار جمهوری اسلامی و گروهه	کشتهشدن یحیی سنوار، چه تاثیری بر رفتار جمهوری اسلامی و گروههای نیابتیاش داردگفتوگو با مجید محمدی، جامعهشناس		
خبرگزاری فارس متن یک استفتاء از علی خامنهای، رهبر جمهوری	ایرال  ر ک ا در این حکم شرعی آمده است در موارد طبیعی و در حد متعارف، دیه ندارد ول ی در موارد خطای عمدی، دیه داردهمچنین درباره خطای عمد در مسابقات ن		
ویدیوی منتشرشده در رسانهها نشان میدهد سنگقبرهای دوره صفوی د			
گزارشها و ویدیوهای منتشرشده در خبرگزاری فرانسه، حمله هوایی اس	گزارشها و ویدیوهای منتشرشده در خبرگزاری فرانسه، حمله هوایی اسرائ یل به جنوب بیروت را در روز شنبه ۲۸ مهرماه نشان میدهدیک منبع امنیتی به خبرگزاری فرانسه گفته که هدف این حملات یکی از پایگاههای حزبالل ه بوده است		
ی، روزنامهنگار	نگار بازداشتی در جریان جنبش مهسا، صادر شده و او باید ظرف ۵ وز خود را برای اجرای حکم حبس به زندان اوین معرفی کند		
روزنامه اعتماد مدارس، والدین را بهخاطر نداشتن شهریه مجبو ر ب	ه نظافت مدرسه کردندجزییات بیشتر با مریم مقدم، ایران اینترنشنال		
ویدیوی منتشرشده در رسانهگلهای از گرازها را در جنگل رامس ر ا	ویدیوی منتشرشده در رسانهها، گلهای از گرازها را در جنگل رامسر ا ستان مازندران نشان میدهد		
محمد سعیدی، نماینده خامنهای در قمگفت ورزشکاران باید توان بد	محمد سعیدی، نماینده خامنهای در قمگفت ورزشکاران باید توان بدنی خ ود را تقویت نمایند تا در مقابل ورزشکاران غربی پیروز میدان شونداف زود اینکه ورزشکاران ما حاضر نیستند در مقابل ورزشکاران اسرائیل می		
وزیر اقتصاد، با اذعان به گستردگی بحران اقتصادی، اعلام کرد، تو	وزیر اق ، ب با اذ ب گ ورال اقص ا کرد ، دوولت بل ای   محود ال آ ی  از  اقای ایرال میگوی		
آخرین واکنشها به حمله پهپادی به خانه نتانیاهو جزییات بیشتر با	آخرین واکنشها به حمله پهپادی به خانه نتانیاهوجزییات بیشتر با اشک ان صفایی، ایران اینترنشنال		
کمیته انضباطی فدراسیون فوتبال، رضا درویش، مدیرعامل پرسپولی	ایرال ایشورزشیک اوه  ف فوت ، ضا د می پ پرلی را  ب ک کمی  ض زیک دوره پرولدد  ۲ میلیارد ت جری  ۳ م از ض د ا صر صورت عذرخواهی ر و پرداخ جری در مد ه ، ی  ی از محو خواهد ش  پولی ، ب وه رای پ  و و  و رومی تیقی ای ب ، ط  رئی فوول فوت گ  ود ز روز  سیاه و یک لکه ننگ برای فوتبال ایران بود به گویند سیاسی هستند، خودشان سیاسی هستنددر ویش با انتقاد از این رای مدعی شده بود هیچ ادله قانونی برای اینکار نی چ امکان اینکه بشود حکم را تعلیق کرد وجود ندارد و همه مسئولان سه کمیته فدراس یون این را گفتند		
تصاویر منتشر شده در فضای مجازی نشان میدهد محمدحسین کنعانی	ایرال ایشو ورزشیاوی ض ضای مجازی     ک ، ب پولی زهای گذش  در  کرج د یک خیالی شه ال او د ش   صول ص   ک  زیکییکییکییکییکییکییکییکییکییکییکییکییکییکی یک نفر کنار خودم شدم    با این حال خیلی زود دست به کار شدم و تونستم گوشی را پس بگیرم دیدم فیلمی از من تو فضای مجازی با عنوان درگیری تو خیابون و زد و خورد    من هیچ درگیری فیزیکی نداشتمکنعانیزادگان فصل گذشته با یک هوادا ر گیر شده بوداز سوی دیگر و در پی این درگیری، کمیت ه اخلاق فدراسیون فوبتال، محمدحسین کنعانی زادگان را جهت ادای پاره از توضیحات باید روز چهارشنبه دوم ابان ۱۴۰۳ احضار کرده است		
باخت سنگین سه بر صفر استقلال به ذوب آهن، بحران در اردوی آب	بحران در اردوی آبیها را عمیقتر کرد   ل و جنگ قهرمانی گرفته است این درحالی که مدیران استقلال با انتخاب پیتسو موسیمانه، سرمرب ی اهل آفریقای جنوبی تلاش کردهاند، تیم را از این بحران خارج کنندگ فتگو با محمد تقوی، ایران اینترنشنال		
در واکنش به مرگ	اندرو تیت، اینفلوئنسر معروف که به تجاوز و قاچاق انسان متهم شده، در واکنش به مرگ یحیی سنوار، رهبر حماس در غزه گفت من فقط میتوانم دعا چ مکه مرگی به شجاعت یحیی سنوار داشته باشم    ماند او شایسته آرامش ابدی است		
تاریخ دموکراسی  آمریکا  دوران بازسازی	تاریخ دموکراسی  آمریکا  دوران بازسازی		
ن هرمزگان و ته	معاون سازمان جمع آوری و فروش اموال تملیکی اعلام کرد که در دو استان ه رمزگان و تهران چایهای دبش موجود در انبار به صورت حراج فروخته خواهد شد می شود		
پرتو برهانپور و حجت کرمانی، وکلای نیلوفر حامدی، روزنامهنگار د	پرتو برهانپور و حجت کرمانی، وکلای نیلوفر حامدی، روزنامهنگار در گ فتوگو با شبکه شرق از صدور ابلاغیه اجرای حکم حبس او با وجود بخشنامه ی ۵ روز خود را جهت اجرای حکم ۵ سال حبس، به زندان اوین معرفی کند		
وبا در روز جمعه ۲	کار افاد  آوگاه آتویوی  ، زرگول   کو جز ۲۷ م م م م م م م م م م     د کشور قط ود ۱۰ میلیوووو    پیش از این اتفاق دولت کوبا تلاش کرده بود با تعطیلی مدارس و مراکز صنع تی، کمبود برق را جبران کند		
ایلان ماسک در یک سخنرانی تبلیغاتی برای دونالد ترامپ گفت که بای	ایلان ماسک در یک سخنرانی تبلیغاتی برای دونالد ترامپ گفت که باید جلو ی کسانی که میخواهند همه را در اسرائیل قتل عام کنند، گرفت وگرنه اس رائیلیهای بیشتری را میکشند و میخواهند آمریکاییها را هم بکشند  میگویند		
ویدیوی منتشرشده، بقایای منزلی مسکونی در بلوار توس مشهد را پس ا	انف جار بر اثر نشت گاز در روز شنبه ۲۸ مهرماه نشان میدهدبر اساس گزارشه    نازل اطراف وارد کرده است		
دولت سوئد، با تروریستی معرفی سپاه از اتحادیه اروپا خواست، این	دولت  ، توریی میکر  از اتایه الوپا خوا  گ گوه را فر فهر   ، ایرال ایت گزارش می د		
در واکنش به مرگ	اندرو تیت، اینفلوئنسر معروف که به تجاوز و قاچاق انسان متهم شده، در واکنش به مرگ یحیی سنوار، رهبر حماس در غزه گفت من فقط میتوانم دعا چ مکه مرگی به شجاعت یحیی سنوار داشته باشم    ماند او شایسته آرامش ابدی است		
اسدالله بادامچیان، دبیرکل حزب موتلفه اسلامی دلیل حصر، جلوگیر	الالله ا  ، د ز موتلف الامی دلیر ،لوگی ققل  یرال ایتشو		
ی شهریه رشتهه	دالشجویا آزاداد ق مقال مج  د اضراض ازایش ۲۰۰ ۲۰۰ رشه ی و  ز جزئیات میگوی		
حرمتالله رفیعی، رییس انجمن صنفی دفاتر خدمات مسافرتی گفت شرک	ی هواپیمایی داخلی سالانه چهار میلیارد دلار از دولت یارانه سوخت میگ یرند این یعنی از جیب فقرا برداشتند، بعد قیمت بلیت هواپیما را ۷۰ دلار بیش تر از قیمت جهانی به مردم میفروشند		
قیمت سکه طلای طرح جدید، با رسیدن به ۵۳ میلیون و ۹۰۰ هزار تومان	قی طلای طرح ج ، ب  بن  ۵۳ میلیول و ۹۰۰ زار توم ، ،وری ثورد ک  صای		
ی به نظر میرسد پ	شاهین مدرس، کارشناس روابط بینالملل و تحلیلگر مطالعات امنیتی به نظر میرسد پس از حمله هفتم اکتبر حماس، اسرائیل جنگ علیه ترور را آ غاز کرده است		
ویدیوهای منتشرشده در خبرگزاریهای رویترز و فرانسه، لحظه رهگیری	ویدیوهای منتشرشده در خبرگزاریهای رویترز و فرانسه، لحظه رهگیری را کتهای شلیکشده از سوی حزبالله را در آسمان حیفا در اسرائیل نشان م یدهد		
سرخط خبرهای شنبه، ۲۸ مهر	سرخط خبرهای شنبه، ۲۸ مهر		
فیلم سینمایی لولیتاخوانی در تهران به کارگردانی اران ریکلیس ف	فیلم سینمایی لولیتاخوانی در تهران به کارگردانی اران ریکلیس فیلمسا ز اسرائیلی و با بازی گلشیفته فراهانی و زر امیرابراهیمی برای نخستین ب    نویسنده و استاد دانشگاه ایرانی مقی م آمریکاست، ساخته شده است		
پس از مرگ یحیی س	نشان میدهد جمهوری اسلامی پس ه سنوار هنوز زنده است و نمرده را مقابل سفارتخانههای برخی کشورهای روپایی و عربی در تهران نصب کرده است		
ویدیوهای منتشرشده در رسانههای اجتماعی، حمله به دفتر شبکه تلوی	ویوهای  د در ول ای اج  ب  شلویزیویزیویزیویزیویزیو ع وا وه وه وول ی راد  ایل ح پ پ آ گ گرفه ک ش تلویزیوووی د وروه از گرو ی  م  حمامی ال  وری خواند		
در بازارهای ایران قیمت هر قطعه سکه طرح جدید به رکورد تاریخی ۵۳	در بازارهای ایران قیمت هر قطعه سکه طرح جدید به رکورد تاریخی ۵۳ میلی ون و پانصد هزار تومان رسیده است در بازار بورس هم برای اکثر شاخصها صف فروش تشکیل شد و شاخص کل بورس ب یش از ۲۴ هزار واحد ریزش کردگفتوگو با رضا غیبی، روزنامهنگار اقتصا دی		
کانال ۱۲ اسرائیل به نقل از یک مقام ارشد دولتی نوشت جمهوری اس	پش ا اشکان صفایی، ایران اینترنشنال		
			
در تبادل اسرای جنگی میان اوکراین و روسیه ۱۹۰ سرباز به کشورهایش	در تبادل اسرای جنگی میان اوکراین و روسیه ۱۹۰ سرباز به کشورهایشان با زگشتند این تبادل به میانجیگری امارات متحده انجام شدگفتوگو با کوروش صحت ی، ایراناینترنشنال		
دو سازمان حقوق بشری نسبت به احتمال اعدام قریبالوقوع محمدرضا ی	دو  ز قوق وری  وه احمال ال ا ق  الو محمد کوککا در ای شد    ریمقدم، مدیر سازمان حقوق بشر ایران		
کانال ۱۲ اسرائیل به نقل از یک مقام دولتی نوشت جمهوریاسلامی پش	کانال ۱۲ اسرائیل به نقل از یک مقام دولتی نوشت جمهوریاسلامی پشت حم له به اقامتگاه بنیامین نتانیاهو، نخستوزیر اسرائیل بوده استگفتوگ و با اشکان صفایی، ایراناینترنشنال		
کنفرانس مطبوعاتی مشترک عباس عراقچی، خارجه جمهوریاسلامی ا هاکا	کنفرانس مطبوعاتی مشترک عباس عراقچی، وزیر خارجه جمهوریاسلامی با ه اکان فیدان، وزیر خارجه ترکیه درباره وضعیت منطقهعباس عراقچی اعلام کر ده که باید مانع دخالت خارجی در مسائل منطقه شویمگفتوگو با فرزیا ثاب تی، ایراناینترنشنال		
مرتضی کاظمیان، ایراناینترنشنال مسئولیت ویرانهای که از غزه ر	مرتضی کاظمیان، ایراناینترنشنال مسئولیت ویرانهای که از غزه بر ج ای مانده، مانند توپی است که از سوی تریبونهای جمهوریاسلامی بهت اکتبر حماس به اسرائیل است که خامنهای آن را ضربهای جبران ناپذیر توصیف کرد		
بامداد امروز آژیر خطر حملههای پهپادی حزبالله در بخشهای بزر	بامداد امروز آژیر خطر حملههای پهپادی حزبالله در بخشهای بزرگی   یکی از پهپادها به یکی از خانههای بنیامین نتانیاهو در قیصریه برخور دکردگفتوگو با اشکان صفایی، ایراناینترنشنال		
بنیامین نتانیاهو، نخستوزیر اسرائیل، در ویدیویی که بعد از حمله	یامی ، خ الائیرائیل ، ویویی  تاکی کرد     ی  توریی ی ایرال ا  می ی ج جگ پیوزواهی ش		
در این گفتوگوی ویژه، جورج هارونیان، کنشگر مدنی جوامع یهودی در	در این گفتوگوی ویژه، جورج هارونیان، کنشگر مدنی جوامع یهودی در آمر یکا از شرایط یهودیان ایران بعد از انقلاب میگویدنسخه کامل برنامه ر ا در یوتیوب تماشا کنید		
شاتر  مروری بر آثار هنر اعتراض	شاتر  مروری بر آثار هنر اعتراض		
صری الیومگفت	ی الیوم گفت ما تهدیدی به بستن تنگه هرمز نکردیم با وجود اینکه در این ز مینه توانمندی بالایماین در حالی استکه حسین شریعتمداریای نده خامنهای در روزنامه کیهان به تازگی تهدید کرد باید تنگه هرمز بسته شود		
ویدیوهای منتشرشده در رسانهها نشان میدهد گروهی از حامیان حکوم	گروهی ر حال اهدای طلاهای خود برای ارسال به لبنان هستند		
ویدیوهای رسیده به ایراناینترنشنال، آتشسوزی یک کارگاه تولید ا	ابر و پارچه را در اصفهان می دهدبه گفته مدیرکل ستاد مدیریت بحران ا اصفهان آغاز شده است		
ویدیوهای منتشرشده در رسانههای اجتماعی، حمله به دفتر شبکه تلوی	ویوهای  د در ول ای اج  ب  شلویزیویزیویزیویزیویزیو ع وا وه وه وول ی راد  ایل ح پ پ آ گ گرفه ک ش تلویزیوووی د وروه از گرو ی  م  حمامی ال  وری خواند		
بهدلیل نداشتن	روزوز اوماد د اج والی داوزاوزا    مداوهلیل ن شی  ک  تای م  م مر خورا در خخ تهیی وه اخ صورت ورت ورت نو کرد در تهراو ، مدر از خالواد ضال تهی آ ای  مدرسه تماس گرفته است		
انیا به خبرگزا	مح یس  ، و هیات  اتاق   ورگا ایرال و الیااری ایلل  ووا  کالای ای کشور و زارهای جهالی و میشود    نها اجازه افتتاح حساب میدهد		
کانال ۱۲ اسرائیل به نقل از یک مقام ارشد دولت این کشور نوشت که	کانال ۱۲ اسرائیل به نقل از یک مقام ارشد دولت این کشور نوشت که جمهوری کرده است که بنیامین نتانیاهو را ترور کنداین گزارش پس آن منتشر میشود که اقامتگاه نخستوزیر اسرائیل و همسرش در قیصریه مو رد حمله پهپادی از لبنان قرار گرفت، اما آنها در محل نبودند		
به دلیل نداشتن	روزوز اوماد د اج والی باوزاوزا   ب  خیری را بهی وه اخ صورت لداد ش  کرده و در تهرا یک مده خالواد ی تهی کو   ظاف  تماس گرفته است		
ویدیوی تازه منتشرشدهای از سوی سایت نهاد علی خامنهای، لحظه رو	ویدیوی تازه منتشرشدهای از سوی سایت نهاد علی خامنهای، لحظه روبوس ی یحیی سنوار، رهبر کشتهشده حماس را با او در زمان دیدارشان در تهران نشان میدهد		
ویدیوهای رسیده میدهد گروهی از دانشجویان علومپزشکی روز ش نبه	ویوهای ری   گوهد از داویا   شوز ش ۲۸ م م  دوه   م فرو تومقالا خم زارت وهداش جم داری و آزاد ک		
هاکان فیدان، وزیر خارجه ترکیه در دیدار و گفتوگو با محمد اسماع	هاکان فیدان، وزیر خارجه ترکیه در دیدار و گفتوگو با محمد اسماعیل د ینوار، رهبر این گروه را تسلیت گفتگفتوگو با فرزیا ثابتی، ایراناین ترنشنال		
نه شخصی بنیامین	دفتر نتانیاهو در یک بیانیه دو جملهای تایید کرد که حزبالله، خانه    ما او و همسرش در خانه نبودند و کسی زخمی نشده استگفتوگو با اشکان صفا یی، ایراناینترنشنال		
پیام علی خامنهای کشته شدن یحیی سنوار به دست اسرائیل فقدان او	پیا  خا  ی کشه ش ی س  د الائیل ققال ای ج مقاومت درد او ای  کرده لح   پیام یش ای ح  ورالل		
یکی از شهروندان با ارسال ویدیویی به ایراناینترنشنال، عکس یحیی	یکی از شهروندان با ارسال ویدیویی به ایراناینترنشنال، عکس یحیی سن وار، رهبر کشتهشده حماس را روی بنری در شهر تهران نشان میدهد و میگ  د		
آموز یکی از مد	فردار شهر  قال ا د و گ که آها یر ومار   ش		
بر اساس ویدیوهای رسیده، گروهی از پرستاران و کادر درمان در زنجا	بر اساس ویدیوهای رسیده، گروهی از پرستاران و کادر درمان در زنجان روز شنبه ۲۸ مهرماه مقابل ساختمان استانداری زنجان تجمع اعتراضی برگزار ک ردند		
گزینههای حماس برای پر کردن جای خالی یحیی سنوار چه کسانی هستند	گزینههای حماس برای پر کردن جای خالی یحیی سنوار چه کسانی هستند گزارش سیر کاکر، ایراناینترنشنال		
فت موسوی وکر	موسوی و کروبی در حصر نیستند، اینها را میروند میبینند، همهکار م یکننداو افزود یک دلیل حصر این است که این احتمال داده میشد دیگرا ن اینها را به قتل برسانند و به پای جمهوری اسلامی بگذارند		
کاوش  شرکت هواپیمایی قطر در ساخت فرودگاه جدید در نزدیکی کیگال	کاوش  شرکت هواپیمایی قطر در ساخت فرودگاه جدید در نزدیکی کیگالی، پای تخت رواندا، سرمایهگذاری عظیمی کرده است علت سرمایهگذاری قطر در رواندا چیست		
ام طرح جدید در م	بر اساس گزارش سایتهای اطلاع رسانی در ایران، قیمت هر قطعه سکه تمام طرح جدید در معاملات روز از ۵۳ میلیون تومان گذشت		
م در حادثه آتش	داد گزارش، این دو کارگر دچار سوختگی ۱۰۰ و ۹۰ درصدی شده و سپس به یمارستان منتقل شدند		
ملات روز به۵۲ می	بر اساسگزارش سایتهای اطلاع رسانی، قیمت هر قطعه سکه تمام در معامل ات روز به۵۲ میلیون و ۶۰۰ هزار تومان رسید		
ویدیوی منتشرشده در رسانههای اجتماعی، منطقه قیصریه، محل اقامت	ویوی مش د ج ی اجما قیص ، م مامت وو ر پ ح پ ی از   شوز  می  گر   الائیرائیل خور کاداده تالیاه ه  ز زمل ،ر خاوده  ک ج مج ا		
دونالد ترامپ روز شنبه ۲۸ مهرماه، هنگام سخنرانی انتخاباتی در دی	ت با مشکل فنی مواجه شد و میکروفون او از کار افتاد		
حسین آقایی، پژوهشگر امور استراتژیک و روابط بینالملل درباره اع	حسین آقایی، پژوهشگر امور استراتژیک و روابط بینالملل درباره اعلام آمادگی پوتین برای میانجیگری میان جمهوریاسلامی و اسرائیل ژئوپولتیک		
ر تسلیحاتی حزب	اسکاینیوز عربی به نقل از گزارش دادکه ارتش سوریه دو انبار ت سلیحاتی حزبالله در حومه دمشق را مصادره کرد این شبکه نوشت مقامهای سوریه تردد اعضای حزبالله و گروههای تحت ح مایت جمهوری اسلامی به سمت جولان و شهر حمص و اطراف آن را به دلیل نگران ی از حمله اسرائیل محدود کردند		
حسین آقایی، پژوهشگر امور استراتژیک و روابط بینالملل درباره اع	حسین آقایی، پژوهشگر امور استراتژیک و روابط بینالملل درباره اعلام آمادگی پوتین برای میانجیگری میان جمهوریاسلامی و اسرائیل ژئوپولتیک		
جاستین ترودو، نخستوزیر کانادا مرگ یحیی سنوار، پایان دورهای	جاستین ترودو، نخستوزیر کانادا مرگ یحیی سنوار، پایان دورهای از		
شها میان جمهور	اعلام کرد برای کمک به کاهش تنش کیها ن وابسته به علی خامنهای نوشته مذاکره بعد از کشته شدن سنوار، رنگ و ب وی تسلیم داردگفتوگو با شهرام خلدی، پژوهشگر روابط بینالملل		
جو بایدن، رییسجمهوری آمریکا میگوید از نحوه و زمان حمله تلافی	جو بایدن، رییسجمهوری آمریکا میگوید از نحوه و زمان حمله تلافیج ویانه اسرائیل به ایران مطلع استگفتوگو با مرتضی انواری، تحلیلگر م سائل ایران و آمریکا		
سخنگوی دفتر نخستوزیری اسرائیل تایید کرد که یک پهپاد با هدف حم	دوی در  الاسول تایی ک پ پاد وهد حمله وه ا  شخصی تالیالیاوه موریه پ ش ، ا ز  او و  د ودها  ک مجروح وهه وه ت قیص ریه خبر داده است		
تضعیف سپاه پا	عیف سپاه پاسداران و بسیج کمک کند		
شدند که دو مور	یدیعوت آحارونوت و العربی جدید نوشتند هدف این پهپاد اقامتگاه شخصی ن تانیاهو بود		
کرد پلیس نامحس	فیروزکشیر، معاون اجتماعی و فرهنگی پلیس راهور تهران بزرگ اعلام کر د پلیس نامحسوس با خودروهای مجهز و مختلف و در قالب پلاکهای شخصی پل اک پلیس به صورت نامحسوس در سطح شهر حضور دارد		
۱۳ درصد بیمار م	او اشاره کرد بین آلودگی هوا و ابتلا به آسم ارتباط مستقیم وجود دارد و افزود در برخی شهرها با افزایش مربوط ه آسماتیک رو به افزایش است		
	جاستین ترودو، نخستوزیر کانادا مرگ یحیی سنوار، پایان دور های از ترس در جهان استگزارش مهسا مرتضوی، ایراناینترنشنال		
باشگاه استقلال پیتسو موسیمانه، سرمربی اهل آفریقای را به	ایرال ایتش ورزشی   ایرال ایتولشال پی  ، س ، سر ی جج ی   ر ای میکند که استقلال چه باشگاه بزرگی است سرمربی اهل آفریقای جنوبی ، معرفی کرداو عملکردها فاوتی داشته است مو   علاو  بک دای یم  فوتوتوتوت جوول الا ، الای عر وس وی و  دو ق د  ی آریقا ب  یم ماملدوی دوالز آریق ج و و ق ق  یگر ای کشرا کار د م م ب  ب ب ب ب   ه  کردنظر شما درباره این سرمربی ۶۰ ساله چیستبرای شرکت در		
واکنش امیر قلعهنویی به منتقدان پس از بازی با قطر و البته	ایرال ایشورزشیوورزشیوامی    قاو ب بر و ال القاتاتاتات ب یی، پ  پ  ز مت برد شی ی د هتتریک		
تغییر کیفیت سردار آزمون و دو گلی که زد، یکی از نقاط مثبت ب	ایرال  ی جام جهالی ۲۰۲۶ توضیات محمد قوی، ایرال ایت		
بازی ایران برابر قطر در مقدماتی جام جهانی ۲۰۲۶، بهترین نما	ایرال ایتورزشی وورزشی ای قطر قطر   جام ج ت  یش ی پ  ی آ ودوضیات مز میرزایی، ایرال ایش		
	ایران اینترنشنال ورزشی		
پیتسو موسیمانه، سرمربی جدید تیم فوتبال استقلال، درباره حضو	ن گفت ، برایتان مشخص میکند که استقلال چه باشگاه بزرگی استسرمربی اهل آفریقای جنوبی، در ادامه با قدردانی از اعتما د مدیران استقلال به خودش، گفته آخرین عنوان قهرمانی استقلال در سال ۲ ۰۲۲ بهدست آمده، ازاینرو میتوان ایمان داشت که هواداران تشنه کسب عنوان جدیدی هستند یک چالش جدی پیش روی ما است اما حضور در این تیم برای ما یک مزیت است		
	ولای پ ، ریی رور الام ک کاهش تش   جمهو الا  ال  ال  ال  ا ا ا ا ا ا ا ا  از س یگ کیهال وال وه و وه وه وه وه وشه مذاکره کش سوار ، و  ی، پژوهشگر روابط بینالملل		
	جو بایدن، رییسجمهوری آمریکا میگوید از نحوه و زمان حمله ت اسرائیل به ایران مطلع استگفتوگو با مرتضی انواری، لیلگر مسائل ایران و آمریکا		
سرخط خبرهای شنبه ۲۸ مهر	سرخط خبرهای شنبه ۲۸ مهر		
دو روز پس از انتش	علی خامنهای، رهبر جمهوری اسلامی، سرانجام در روز شنبه، ۲۸ مهر، دو و با انتشار بیانیهای، مرگ او را برای جبهه مقاومت دردناک خواند		
شهروندی با ارسال پیامی صوتی به ایراناینترنشنال در ککنش به ب م	شهروندی با ارسال پیامی صوتی به ایراناینترنشنال در واکنش به مطلب م اجتماعی ایکس درباره کشته شدن یحیی سنوار  تی و جنگیدن را بلدی، کافیست تو و انگلهایتان دست از غارت ایران بردارید و برای جنگ با اسرائیل به لبن ان بروید، نیازی به ریختن اشک شوق نیست		
فوزیه سیدو، دختر ایزدی که اوایل مهر ماه از اسارت یک عضو حماس د	فوزی  ، ، خ ایز که اوایل  ما الت یک ضو ح غزاد ، ،ومصاحوه وزوزایایی س  م هر ملشر ش ، ب ش ه هوللاکی کر ال داو و و ج کرد گ ای گوهیچ یچ یچ گوهیچ فرقی با هم ندارندفوزیه گفت هنگامی که ۱۰ سال پیش به دست داعش در عراق  ودکانی را که کشته بود گرسنه مانده بود ند ناچار بودند این گوشت را بخورند		
از مخاطبان ایراناینترنشنال پرسیدیم کشته شدن فرماندهان ارشد نی	تی چه تاثیری بر حکومت ایران خواهد گذاشت شهروندی با ارسال پیامی صوتی میگوید کشته شدن یحیی سنوار این پیغام  ق مردم ایران بگیرد و در شکم یک مشت تروریست بریزد، دارد تمام میشود		
شهروندی با ارسال ویدیویی به ایراناینترنشنال زبالههای جمعش د	شهروی ار ویویی وه ایرالایش ز ز  ی جم د ش واقواق  چ ته  د و  ر یوه  در ات اقی وه الائیل ، ت زیاد ارزشی جمهو ا  و ک ک ا  ب یچک  دام از آها هیچ اقدامی نکردند		
موضوعات گفتوگوی بایدن با سران کشورهای آلمان، بریتانیا و فران	موضوعات گفتوگوی بایدن با سران کشورهای آلمان، بریتانیا و فرانسه جزئیات بیشتر در گزارش سمیرا قرایی، ایران اینترنشنال		
حیی سنوار جزئیا	ی سنوار		
تنش میان دولت لبنان و جمهوری اسلامی یک منبع نزدیک به قالیباف	تنش میان دولت لبنان و جمهوری اسلامییک منبع نزدیک به قالیباف برداشت ها از سخنان قالیباف درباره تحولات لبنان اشتباه است		
	اروپایی به کشتهشدن یحیی سنوار		
ر مخالفت خود با ح	شازاد رضا پهلوی گوگوگو وگو ا کایوز الالیا ب تاکی ب ف بمله  وه ای اصلی خود یی مردم ای		
ویدیوها و گزارش منتشرشده در حالوش حاکی است روز ۲۷ مهر ماه،	ویدیوها و گزارش منتشرشده در حالوش حاکی است روز جمعه ۲۷ مهرما ه، شبکه خط لوله انتقال گاز شهری در منطقه شیرآباد زاهدان در پی نشت گاز در شب گذشته و عدم توجه مسئولان آتش گرفته و دستکم یک خودرو دچار آتش سوزی شدتا لحظه انتشار خبر از تلفات جانی احتمالی گزارشی منتشر نشده استشب گذشته، حالوش نشتی گاز و شعل کرده بود		
	ت می دولت ل ووری الامییک  قالی ش ش  ال قالی د تولات ل اش ا		
ع بودن او از زما	خارجه جمهوری اسلامی در واکنش به اظهارات جو بایدن درباره مطلع ودن او از زمان و شیوه تلافیجویانه اسرائیل عمهوری اسلامی، در ایکس نوشت هر کس از چگونگی و زمان حمله اسرائیل به ایران با خبر باشد و از آن حمایت کند، باید برای هر		
ویدیوی منتشرشده در شبکههای اجتماعی حاکی از وقوع طوفان نمک د	ونتشرشده در شبکههای اجتماعی حاکی از وقوع طوفان نمک در د ه به خشک شدن قسمتهای زیادی از بستر دریاچه اشاره کرده است		
ید کره شمالی نیر	اعزام نیروهای کره شمالی به روسیهسازمان اطلاعات کره جنوبی میگوید کره شمالی نیروی نظامی برای جنگ در اوکراین اعزام کرده است		
جزئیات صحبت های بایدن درباره آتشبس و آگاهی از زمان و شکل پاسخ	ئیل گزارش سمیرا قرائی، ایران اینترنش نال		
ادامه واکنشها به کشتهشدن یحیی سنوار جزئیات بیشتر درگزارش اش	صفایی، ایران اینترنشنال		
کانال ۱۲ اسرائیل گزارش داد که این کشور از آمریکا درخواست کرده	کالال ۱۲ ا ش جمهوری الامی وه حمله تلایجویاویا اح ی اس		
شبکه خبری سیانان به نقل از منابع اسرائیلی گزارش داد جسد یحیی	حماس مورد استفاده قرار گیردسنوار روز ۲۵ مهر در حمله اسرائیل به رفح کشته شد و جسد او به این کشور انتقال یافت یک گیپلماتیک اسرائیلی گفت اگر حماس میخواهد جسد او را با گروگ انهای اسرائیلی، چه زنده و چه مُرده، مبادله کند، مشکلی نیستاو افزو س برآوردها، هنوز حدود ۷۰ گروگان اسرائیلی در قید حیات در اسارت گروههای مسلح فل سطینی در نوار غزه هستند گزارشها همچنین حاکی از آن است که جسد حدود ۳۰ گروگان همچنان در این باریکه نگهداری میشود		
کوبا روز جمعه پس از کار افتادن یکی از بزرگترین نیروگاههای خود	کوبا روز جمعه پس از کار افتادن یکی از بزرگترین نیروگاههای خود و خا موشی شبکه ملی برق، دچار قطعی برق سراسری شد کمونیستی کوبا پیشتر مدارس و صنایع غیرضروری را تعطیل کرده و ر کارمندان دولتی را به خانه فرستاده بود تا در مواجهه با کمبود شدید گیتراس، بزرگترین نیروگاه کشور، از مدار خارج شد و باعث قطع کامل شبکه برق شد که حدود ۱۰ میلیون نفر را بدون برق گذاش ت مقامهای این کشور هنوز توضیحی درباره علت خرابی نیروگاه ندادند		
	ادامه واکنشها به کشتهشدن یحیی سنوارج		
	احمد صمدی، ایران اینترنشنال از مهمترین نکات نشست سران آم ریکا، بریتانیا و فرانسه در برلین می گوید		
شها در خاورمیان	محمدنبی موسویفرد، نماینده خامنهای در خوزستان، با اشاره به تنش اسرائیل علیه امی گفت آمریکا بداند ما به ناچار با آمریکا و قدرتها شاخ به شاخ خواه یم شد و امت اسلامی اراده کرده است شاخ آمریکا را برای همیشه بشکند		
ابراز امیدواری بایدن از پایان تنش بین اسرائیل و جمهوری اسلامی	ا  امیواری وای پایال تش ول و جمهوری الامی و ا  ز  امی		
ابراز امیدواری بایدن از پایان تنش بین اسرائیل و جمهوری اسلامی	امیواوا پایال تش ول و جمهوری الامی و ام از زم و زم و شیوه پا    بم ج امی  در گوگو بوگو آ ح ح  الاد وم ی و  فره ، تلی		
خانههای اطر	کانال ۱۲ اسرائیل گزارش داد که نیروهای اسرائیلی در جریان جستجو در خا نههای اطراف محل کشته شدن یحیی سنوار، تعداد زیادی از نامهها و مکات		
ه تاسیسات هسته	اسیسات هستهای در ایران، روی میز اسرائیل برای پاسخ به حمله موشکی جم هوری اسلامی است او افزود هیچ تاسیسات نظامی یا زیرساخت یا شخصی در ایران وجود ک		
	اظهارات جدید ترامپ درباره مواضعش در قبال ایران در پادکست پ یبیدی		
ه، خبر داد که د	خبر داد که در پی تصادف زنجیرهای چند خودرو از جمله سمند، تیبا وای		
	۲۴ با فرداد فرحزاد		
بایدن میتوانیم چرخه حملات تلافیجویانه جمهوری اسلامی و ٔیل ر	بایدن چرخه را متوقف کنیمجزییات بیشتر با سمیرا قرایی، ایران اینترنشنال		
می در خاک ایران	نظامی		
حرف آخر با پوریا زراعتی  ۲۷ مهر  ۱۴۰۳  ۱۸ اکتبر	ح بوریا ز م م مهر  ۱۸ ۱۸ اکویه صوی ی برف ب  پور  ذ ی ییوار زم ق و اهمی ذ یواوا وه وواو  ج  اک ، پیش ز آغ ولیاتا مواضع جمهوری اسلامی در خاک ایران پرداختمو این پرسش مهم جمهوری اسل امی چه برگ برندهای در دست دارد		
هگفت اسرائی	د نمیرسداو افزود چون سنوار با طراحی طوفانالاقصی چنان ضربهای ه اسرائیل زدکه هیچ وقت از این زخم کاری بهبود نخواهد یافت		
تلاش دولت آمریکا برای از سرگیری مذاکرات آتشبس پس از کشته شدن	تگیری سنوار		
با اعلام رسمی باشگاه استقلال، پیتسو موسیمانه، سرمربی اهل آ	یمانه، سرمربی اهل آفریقای جنوبی، بهعنوان سرمربی جدید تیم فوتبال ا ین باشگاه انتخاب شد الاهلی بستان سعودی و همچنین دو قهرمانی در جام باشگاههای آفریقا را در کارن    هدایت ابها و الوحده امارات را هم تجربه کرده است		
ورزش سه ویدیویی منتشر کرده که نشان میدهد بازیکنان استقلال	گ برتر، مات و مبهوت در رختکن ورزشگاه شهر قدس نشستهانددر این بین روزبه چشمی، هافبک مصدوم استقلال که  ل غیرورزشی د		
حسین حسینی، کاپیتان استقلال که پس از افشاگری درباره پرداخت	ایرال  یایی وی ف ب  کمی  الضطی واه ارار و می می اشگ زمری و و و اینکه آیا صحبتهایش را تکذیب کرده، گفت من همیشه راه حجازی را ادامه میدهم		
باخت سه  صفر استقلال به ذوب آهن و بازی بد آبیپوشان علاوه	با واکنش پرکنایه آنها هم همراه شد		
همزمان با بازی بد استقلال با ذوب آهن، که منجر به شعارهای ت	منجر به شعارهای تند هواداران این تیم علیه احمد شهریاری و فرشید سمیع ی شد، رییس هیات مدیره و مدیر عامل باشگاه، پیش پایان بازی، استادیوم قلعه حسن خان را ترککردند		
قماربازها روی که شرط میبندند ترامپ یا هریس، سایتهای شرطبند	قماربازها روی که شرط میبندند ترامپ یا هریس، سایتهای شرطبندی چ زیر استفاده کنید		
شایان سمیعی، کارشناس امنیت ملی در ایالات متحده تا یک ماه پیش،	شایان سمیعی، کارشناس امنیت ملی در ایالات متحده تا یک ماه پیش، شرط ب ندی روی نتیجه انتخابات غیرقانونی بود اما یک ماه پیش یک دادگاه این موضوع را قانونی اعلام کرده است و برای ب		
ر برای قرار گر	خارجه سوئد در پاسخ به ایران اینترنشنال درباره تلاش این کشور ب رای قرار گرفتن سپاه پاسداران در فهرست گروههای تروریستی اتحادیه ار  ما مدتهاست که به دنبال حمایت اتحادیه اروپا در این خصوص هستیم		
هریس پیشتاز است	آخ  فی ی کارز ترامپ و  ور    ملی هری پیش جزئیات یشر در گزارش الدوز ، ایرال ال		
آرش آرامش، حقوقدان و کارشناس امنیت ملی بسیار میدانم قبل ا ز	آرش آرامش، حقوقدان و کارشناس امنیت ملی بسیار بعید میدانم قبل از اگر هم برقرار شود تاثیر چندانی انتخابات آمریکا نخواهد داشت زیرا عموما مسائل سیاست خارجی تاثیر آنچنانی بر انتخابات ایالات متحد ه ندارد		
کشته شدن یحیی سنوار چه تاثیری بر انتخابات آمریکا و مذاکرات آتش	کشته شدن یحیی سنوار چه تاثیری بر انتخابات آمریکا و مذاکرات آتشبس خواهد گذاشتسمیرا قرایی، ایران اینترنشنال گزارش میدهد		
تیم فوتبال استقلال در بدترین نتیجه ده فصل اخیر خود در لیگ	صگ گل برابر ذوبآهن شکست خورد هواداران استقلال که به شدت از عملکرد کادر مدیریتی باشگاه ناراضی بو  د		
ایسنا گزارش داده پرسپولیس در لایحه اعتراضی خود به کمیته اس	محرو تعلیقی این بازیکن بابت نمایش حرکت سر بریدن در مقابل هواداران اس استناد کرد و خواهان ال محرومی چهار ما بورت قط  ش  ا گزارش ای آ آ آ آ آ ز صور  پرود    تو ی  را فوت ، اشگاه پ پولی ولی ول وه ایوه ای او کرد و لای خود را ی  است ح ایا د ای لایه اطلا د  پیا کرد کولشال  پولی  لی اشار ک الد  آمده   ال ، ، ل  خود ، ب  حرک یراو ب ز ی ز ز ز پی پی یک بر صفر پرسپولیس برابر استقلال در داربی ۱۰۰، اشاره دارد که در آن نشان میدهد که بعد از بازی هم نکار او با شکایت باشگاه استقلال همراه بود و کمیته انضباطی او ربم ه کرد		
حماس در بیانیهای شدن محمود حمدان ملقب به ابو یوسف، فرماند ه	ردان تل السطان در رفح را تایید کرد		
آنتونی بلینکن، وزیر امور خارجه آمریکا، و آنالنا بربوک، همتای آ	آتولی ولی  ، وزی خارجمریکا ، و آنال وک،  های آلما ال اوهای مش آآ در وار غز    کردود ود و و و کشه او میویی تلاش خاتات و درگیا د ووه را		
هرتزی هالوی، رییس ستاد کل ارتش اسرائیل در گفتوگویی خطاب به فر	زی هالوی، ریی کل ارش الائیل گ یالد ک  او همچنین در بخش دیگری از سخنانش افزود بر اساس برآورد ما، هزار و پا نصد کشته شدهاند		
ران، در خصوص کش	ن، در خصوص کشته شدن یحیی سنوار در شبکه ایکس نوشت کشته شدن سنوار مرگ ا		
هواداران استقلال حاضر در ورزشگاه قلعه حسن خان پیش از شروع	ایرال ایشورزشی ورزشیووا ا  حاضر ورزشگاه قل ح ز شروو  ذ  ذ ا مییی ای اه ، وهریاری و و و و و و  ول هیات میره و  باه ، شار ک ، ر  س   ک		
جو بایدن، رییس جمهور آمریکا، در پاسخ به پرسش خبرنگاران در برلی	جک    نه دارد اما به جزییات آن اشارهای نکرد		
علی شمخانی، مشاور سیاسی خامنهای، در خصوص کشته شدن یحیی سنوار	علی شمخالی، مشاور ی خا دوص دوص کش  ی ی سیی س دل ش ایک ص لم ورا وها وه دل یم او ازود در حالی ک شک شوق و ح الم     م		
تیم فوتبال زنان سپاهان در اولین بازی خود در فصل جدید لیگ ب	ایرال ایشورزشیم فوتوتوتوت ز  پاول اولی بود خود صل ل لیگ  گلگ   بوه پی تا وازیک ال ای یم ایچ جش ور یگ وهای ای هفه ، ی ک نتیجه پرگل شش بر یک برابر پالایش گاز ایلام برنده شدطاران البرز ه م در خانه با یک گل برابر تام اصفهان شکست خوردویدیو فوتفم		
وزارت خارجه سوئد در پاسخ به ایران اینترنشنال به دنبال قرار دا	خارج  در پا  ایرال ایت  د قار ن پا در ته تور ی اتار س ال وایال ، ای		
فرشید سمیعی، مدیرعامل استقلال، در حال ورود به ورزشگاه شهر	شود یا نه، گفت انشاءالله		
مصطفی مهرآیین، جامعهشناس در میز گردی درباره درگیری جمهوری اسل	مصطفی مهرآیین، جامعهشناس در گردی درباره درگیری جمهوری گروهی		
حساب ایکس ارتش اسرائیل به کشته شدن یحیی سنوار، رهب	ی سنوار، رهبر حماس منتشر کرده که انهدام ساختمان محل حضور او را از زاو یه دیگری نشان میدهد		
محمد محمدی گلپایگانیس دفتر رهبر جمهوری اسلامی گفت خداوند د ر	گلپایگانی، رییس دفتر رهبر جمهوری اسلامی گفت خداوند در  همه میگفتند اجازه ندهید رهبر در نماز حضور یابد اما او با کمال آرامش سخن گفت و		
با نشریه فیگارو	میق  ل ل ل     قالی ، یگاور  اج ش ۱۷۰۱ورای ا ا اخله آشکاور ا داخالی کشورش خوالد و خوال ار کاردارت جمهو در  لورا وز گزارش می		
کشتهشدن سنوار، باعث تغییرات در سیاست گروههای مسلح عراقی نزدی	نزد یک به سپاه شده استارزیابی تروسکه صادقی، روزنامهنگار		
سنوار اشکان صفای	اسلامی اراشکان صفایی و سمیرا قرایی، ایران اینترنشنال گزارش میدهند		
ورزش سه ویدیویی از درگیری بازیکنان تیم پیشکسوتان پرسپولیس	فرد، فنونیزاده با بازیکنان حریف، تیم پرسپولیس را به بیرون از زمین هدایت میکند		
نیمار جونیور، فوقستاره برزیلی الهلال که از زمان پیوستن به	که از زمان پیوستن به این باشگاه، در رویدادهای مختلف برگزارشده توسط ع    در جام شش پادشاه در ریاض رفت و با ستاره های دو		
ادرسون، دروازهبان منچسترسیتی، درگفتوگو با تیانتی اس پر	ایرال ایشو ورزشیادوول ،    چ د یال ا  ،ر  وش  ی ا و احمال امام یولا  و ، واهاه آ آماد اد دووو  دول خو وا ای   ب  لیای کرد کار  اگر به عنوان یک بازیکن با گواردیولا پیشرفت نکنید، این نشاندهنده ن		
وینیسیوس توبیاس، بازیکن ۲۰ ساله شاختار که پیش از این دو فص	که پیش از این دو فصل به صورت قرضی در تیم دوم رئال مادرید توپ زده بود، پس از آزمایش دیانای متوجه شده پدر بیولوژیکی دخترش نیست توبیاس حتی نام این دختر، مایت، را بر بدنش تتو کرده بود ای ، پارت  تولا ، ایوضوضو  تایی کرده ا التورای  ت  ک  دو ، صاح یک خخر شه وه ، اخیً از طریق آزمایش ییا  ش که او پولوژیکی خ   ت  ح نی ولا ای خ وی وی  تو کود بود   توضی ایک کاکووو وه ویيی تول تم ش  ، ، ، ن ن ن ن ن  کور ک   ی ، م م و وینیسیوس مدت زیادی با هم در ارتباط نبودیم و در این بین من با یک نفر وارد رابطه شدم پس از آن از او جدا شدم و دوباره به وینیسیوس برگشتم و در این بین مایت بهدنیا آمد ما تصمیم گرفتیم آزمایش دیانای بدهیم و از وینیسیوس خواستم در تول د او هم شرکت نکند تا آزمایش بدهیم		
فرد و داستانها	شهرگرد  نگاهی کوتاه به معماری شهری ایران معرفی بناهای منحصربهفرد و داستانهای ناگفتهشان		
، گفت که برخی ن	اقتصادی استانداری گفت که برخی نانواییها گرانفروشی میکنند و برخی دیگر در قیمت دست برده و بعضی دیگر چانه نان را کم میکننداو گفت که قطعا سهمیه این نانواییها قطع خواهد شد		
فشار نظامی اسر	تاز ائیراشا د ارش ای کشور  مق ا  ی سن وار پی شار ا  ائیل ازووو قل ش و در ک د مواقو ز مخ ود ومیکرد وه وه ولطق  وردو  الموا  ک کوه ش  و کش  شه		
حزب جنبش انصاف پاکستان از طرفداران خود خواست برای آزادی عمران	می دهد		
وزیر دفاع آمریکا، کشتهشدن سنوار را فرصتی برای پایان جنگ خواند	دفاع آمریکا، کشتهشدن سنوار را فرصتی برای پایان جنگ ق پارسا، ایران اینترنشنال از نشست سران کشورهای ناتو میگوید		
باید فقر را مهارکنیم،	دالوی یاضی، عضو کمی آموزش و و و و و گ گ گ ق قر  ک ،وو تووو زود قر اق ای و کا یی ک  دوزوه ف م  ال وجود داش ش ، م ز  از ت ت صی شده است		
یی سینوار نوشت	عباس عراقچی، وزیر خارجه جمهوری اسلامی در شبکه ایکس درباره مرگ یحیی سینوار نوشت که او از مرگ نترسید و در جستوجوی شهادت در غزه بود او شجاعانه تا آخر نبرد در میدان مبارزه جنگید عراقچی افزود سرنوشت س نوار به زیبایی در آخرین تصویر از او نقش بست		
بر اساس گزارشها و تصاویر منتشرشده، بامداد جمعه ۲۷ مهرماه، ۴۳	ال گزارش و صاوی ، بامداد ۲۷ ۲۷ ۲۷ ۲۷ ۴۳ ۴۳ هکاراراضی  حاظاظ ظ پ طروه حوریق  د الگیو ا از الای شای ش  س ۱۴۰۳ چ چ  آ د کشاورزی و  ح حاظ ظ  ق ال		
ن یحیی سنوار گفت	محمدحسن ابوترابیفرد، امام جمعه موقت تهران، با اشاره به کشته شدن ی حیی سنوار گفت اسرائیل در صورت ادامه تجاوزات باید منتظر معجزه مقا ومت غزه و حزبالله که هیمنه آنان را لگدمال میکند باشد او افزود برخی صاحبنظران غربی نوشتهاند اسرائیل از نظر استراتژیک تمام شده است		
رضا غیبی، روزنامهنگار اقتصادی از گرانی و کمفروشی در بازار ای	نگار میگوید		
رهبر حزب دموکراتهای سوئد، خواستار بستهشدن سفارت جمهوری اسلا	رهبر حزب دموکراتهای سوئد، خواستار بستهشدن سفارت جمهوری اسلامی در این کشور شدجزئیات بیشتر با مهران عباسیان، ایران اینترنشنال		
احمد وحیدی جبهه مقاومت، نظم جهان تکقطبی را بر هم زده است اس	احمد وحیدی جبهه مقاومت، نظم جهان تکقطبی را بر هم زده است ائیرائی پ یک س واوه و اهداش غز یا و ور ض خخ از ز خالله ال ال ا ف فال تلیلگ		
عضو جیهفت خواه	شهر ناپل نشست وزرای دفاع کشورهای عضو هفت خواهد بودکیمیا قربانی، ایران اینترنشنال از موضوعات نشس ت سهروزه میگوید		
معاون دفتر سیاسی حماس، مرگ یحیی سنوار تایید کرد جزئیات بیشتر	در  ی ح ، م م ی ی س  س سایی کورد ات ور ا اساقی، ایتووو ب کاکی ک یگیگورهای حامی اوک ، ایران اینترنشنال		
سرخط خبرهای جمعه ۲۷ مهر	سرخط خبرهای جمعه ۲۷ مهر		
یفری، به زودی	برای کاهش سن مسئولیت کیف ری، به زودی کودکان ۱۰ ساله میتوانند بار دیگر در این منطقه زندانی شو ند ایالتها و مناطق استرالیا تحت فشارند تا مطابق با سایر کشورهای توسع		
خلیل الحیه، معاون دفتر سیاسی حماس، با تایید مرگ یحیی سنوار گفت	خلیل الیه ،  د د  ح ، ب ب تایی مرگ ی یی س گ ش  او و رال پیش ا تورت و و ق ج  وا ازود ارتش اسرائیل روز پنجشنبه از کشته شدن سنوار به دست نیروهایش خبر داد		
محمدمهدی میرباقری، عضو مجلس خبرگان رهبری برای رسیدن به مقصد،	اگر ن یمی از مردم جهان کشته شوند، ارزش داردگفتوگو با مرتضی کاظمیان، ایر ان اینترنشنال		
رونشست زمین در ت	ی الهی، ال دا وه اوام ایک  جز الال ، زمی ت تم ال ال  ش ، گ گ گ گ ف ف د حال از اس و و و و و و و و وه عمق فاجاج پی ب الگگوگوگوگوگوگوگ  مخصص و		
جو بایدن، رییسجمهوری ایالات متحده در سفر یک روزهاش به آلمان	ج   د   جهال گوگو کگگوگوگوگوگوگوگوگ  صمی، ایرالایشو		
بهائیان و نوسازی ایران  ایران یل از دانشگاهه	بهائیان و نوسازی ایران  اشرف، نخستین زن ایرانی فارغالتحصیل از دانشگاههای آمریکا بود    یا در علوم تربیتی فارغالتحصیل شد پس از بازگشت به ایران، مدیریت مدرسه بهائی دخترانه تربیت را بر عهده گرفت در کنگره زنان شرق به نمایندگی از ایران شرکت کرد و بعدها در سازمان خد کارگران پرداخت		
ان کشورهای شورا	خ گزاری فار ، وا و  داه در واکش و و و    ش کشورای شورای همک خلیج فاو و اتای  و و ا ار  ا   آ  ها  مالکی جزای توچک و و لگ و ال  ش شک گور  اله خوالد		
شاه اردن دیدار	جورجیا ملوو ی ولت ل خود خود ،  ی و و و و و و و و و ع  ،اه ایار   ق ق ی، ایت		
جو بایدن در برلین مرگ سنوار میتواند مسیر صلح در غزهای بدون	جگ را هموار کنداو در ادامه گفت پس از حمله موشکی جمهوری اسلامی به اسرائ یل، ما در گروه ۷ برای تحریمهای هماهنگ علیه جمهوری اسلامی به توافق ر سیدیم		
محمد محمدی گلپایگانی، رییس دفتر رهبر جمهوری اسلامی گفت ی در ا	مح گلپ گلپاو ی، در  ج  ج جالا گ گ خا در طاهی، پیشگویی و پیشی ول ال او ازود ا ز ویژگی شجاو  دور دل مرد خووردا  ای از ووولات ال		
روه در غزه، را ت	باسم نعیم، از مقامهای ارشد حماس کشته شدن یحیی سنوار، رهبر این گرو ه در غزه، را تایید کرد او مرگ سنوار را دردناک خواند و افزود اما ما در نهایت پیروز خواهیم ش دیحیی سنوار با حمله ارتش اسرائیل در رفح کشته شد و جسد او به مکانی مخ فی منتقل شده است		
عباس عراقچی، در ادامه سفرهای منطقهای خود، امروز، جمعه ۲۷ مهر،	عباس عراقچی، در ادامه سفرهای منطقهای خود، امروز، جمعه ۲۷ مهر، وار در این سفر میگوید		
نجیب میقاتی، نخستوزیر لبنان دخالتهای جمهوریاسلامی در امور ل	میق  ل ل  ل خال ی ج		
دو مهاجم مسلح با عبور از مرز اردن و اسرائیل، به سوی سربازان اس	لی آتش گشودند    شدندبابک اسحاقی، ایران اینترنشنال گزارش میدهد		
جو بایدن، رییسجمهوری ایالات متحده در سفرش به آلمان با برخی از	جو  ، ریی ایالات مت  گ		
دن یک مرد ۷۸ سال	رسادند پزشکان در این کشور هنگام بررسی بدن یک مرد ۷۸ ساله اهل بیرمنگام که اعضای بدنش را برای اهداف علمی اهدا کرد ه بود، دریافتند که او با سه آلت تناسلی متولد شده بود پزشکان میگویند که از هر پنج تا شش میلیون نفر یک نفر با بیش از یک آ لت تناسلی متولد میشود		
شاتر  مروری بر آثار هنر اعتراض	شاتر  مروری بر آثار هنر اعتراض		
ار سفارت جمهوری	نجیب میقاتی، نخستوزیر لبنان از وزارت خارجه این کشور خواست کاردار    اف توضیح بخواهد		
ی خود متعهد شد	ود متعهد شدند این اقدام به افزایش ۲۰ درصدی پسماندههای مواد غذایی در پایتخت سوئد منجر شده استگزارش مهران عباسیان، ایراناینترنشنال		
نجیب میقاتی، نخستوزیر لبنان سخنان محمدباقر قالیباف، رییس مج	یقای،  ل ل   مح قالی ، ریی  ایرال صاحوه باو  بماگی جمهو ذ   فرال  اج ۱۷۰۱ س سما و جوو جلو  جلاو   ا کشورش خ و ازود اج ای قط م قط  دولت لبنان است		
ایاش به ترکیه سف	وا ریی جمهو در ا  سا   ی ای وه ترکی  ک کوگوگوگوگوگوگوگوگوگوگوگوگ  والله  ،		
بابک اسحاقی، ایراناینترنشنال سنوار در حالی که یکی از دستها	بابک اسحاقی، ایراناینترنشنال سنوار در حالی که یکی از دستهایش اسرائیلی ار گرفته بود، نشسته بود  ه فرستادند و سنوار ، چوبی به سمت ریزپرنده پرتاب کرد		
بر اساس تصاویر منتشرشده در رسانههای اسرائیل، یک گذرنامه که ب	ال صاویر  مش د ر  ، گذ گذووه ک  کش ی ی سی س ، ر ح ک او پی م ق م م ب م م م ی حی یمیال ز ، اهل و  آژال امدادالس   آ آ فل ف		
واقعیت مجازی، تکنولوژی است که حضور در محیطهای مجازی سه بعدی آ	واقعیت مجازی، تکنولوژی استکه حضور در محیطهای مجازی سه بعدی آنلا ین را فراهم میکند این تکنولوژی در کنیا که پنجاه و یکیمین کشور فقیر جهان در ردهبندی ص ندوق بینالمللی پول است، استفاده شده استگزارش فرزیا ثابتی،ایران اینترنشنال		
مهسا فرزان، دبیر تشکل زنان انقلاب اسلامی گفت از زمانی که ماه	فرزا ، د شک  ز القلا الامی گ  زما ک   کش ور ش و ب آزاد ش ای ، مطال س ک  محصول جایگزین هم برایش بگذاری		
حماس، او را یک	س، او را یک تروریست تحت تعقیب خواند و تاکید کرد ما مهمترین فرمانده ان حماس را کشتهایم و به تخریب توانمندیهای نظامی حماس ادامه میده یمگفتوگو با مئیر جاودانفر، تحلیلگر مسائل اسرائیل		
شاره به حمایت جم	محمد وریا ، ف اصلاط  و و و و زو زارگزاول   گی، وه حمای ج  الامی از ورو ی گ از یییی یییی یییی یییی ییییی  یرا ت یک یک کلی دارلد ک فارغ از ایک  ج ی ا اصولگ یاصلاطاش ولد ، ،ی تا  ساز مخالف نزنند		
یوآو گالانت، وزیر دفاع اسرائیل، در پی عملیات نظامیان این کشور	یوآو گالا ، وزی دال  ، پیور پی پیات وظامیال ایور غز  ف و آ  ا از وواهیم و		
مسعود فلاحی، جانشین فرمانده سپاه خوزستان، گفت امروز نوجوان	گفت امروز نوجوان و نان دختر و پسر ما باید به وعده صادق و رهبر خود افتخار کنند ای ورا  خولوایری ک د ومک   وه وولد  ازود ازود ب		
نتانیاهو مردم اسرائیل، یک سال پیش در حالی که داشتیم عید را ج	نتانیاهو مردم اسرائیل، یک سال پیش در حالی که داشتیم عید را جشن می گرفتیم، یحیی سنوار برای کشتار هفتم اکتبر آماده میشد حالا من پیش روی شما ایستادهام تا بگویم یحیی سنوار کشته شده است اما هنوز ماموریت ما تمام نشده و آن بازگشت عزیزان شماست که عزیزان ما هم هستند		
دنبال جنگ نیست	گفت که جمهوری اسلامی  به دن بال جنگ نیست اما با حکمت خامنهای فتنه دشمنان را خنثی میکنداو افز ود در حمله اول به اسرائیل جمهوری اسلامی به دنبال قدرتنمایی ر حمله دوم این قدرتنمایی بیشتر شد		
رهبر کره شمالی، کره جنوبی را یک کشور خارجی و دشمن توصیف کرد و	رهبر کره شمالی، کره جنوبی را یک کشور خارجی و دشمن توصیف کرد و هشدار می  ه نظامی راکنار نخواهد گذاشتگفتوگو با توماج طاهباز، ایراناینترنشنال		
ه مهم تاریخی د	آنتونیو آلبانیزی، نخستوزیر استرالیا، مرگ یحیی سنوار را یک لحظه م هم تاریخی دانست که نقطه عطفی در درگیری ویرانگر حماس و اسرائیل استگفت وگو با علیرضا محبی، ایراناینترنشنال		
شایان سمیعی، کارشناس امنیت ملی نتانیاهو باید موفقیتهای پیاپی	شایان سمیعی، کارشناس امنیت ملی نتانیاهو باید موفقیتهای پیاپی نظ امیاش را به موفقیتهای سیاسی تبدیل کند		
محمد سلطانی، عکاس نجومی، ویدیو و تصاویری در اینستاگرام از طلوع	مح  ولی، ومی، ویو و و و واوی   دهه پل خواجو و ور یوم ج شال ث شهاوی در ایوشوش ا  ا  ششماه پیش ششماه پیش ششماه پیش ششماه پیش شش پیشم پیشماه پیشم پیش پیشماه پیشم پیشماه پیشم پیشماه پیش با بررسیهای دقیق دریافتم که در تاریخ بیست و ششم مهرماه امسال، ماه کامل در حالی عمود بر محور پل خواجو طلوع میکند که در نزدیکترین فاص		
رادیو ارتش اسرائیل پنجشنبه ۲۶ مهر به نقل از منابع ارتش اعلام	رارو الش ا ده ا سنوار یکی از طراحان اصلی حمله مرگبار هفتم اکتبر به اسرائیل بودگفت وگو با شکریا برادوست، پژوهشگر امنیت بینالملل و سیاست خارجی		
سرخط خبرهای جمعه ۲۷ مهر	سرخط خبرهای جمعه ۲۷ مهر		
شهروندی با ارسال ویدیویی به ایراناینترنشنال قیمت دو کره را از	شهروی ار ویویی وه ایرالایش قیمت  ز یک دوو زما ۱۶ ر مقای و  یو ، یش و از ۱۴ د اایش قیمت داشم تورم در ایران هر روز و هر شب دیده میشود آیا کارگر و کارمند با این تورم میتوانند زندگی خوبی داشته باشند		
شهروندی با ارسال ویدیویی ازکرج به ایراناینترنشنال به ساختوس	شهروندی با ارسال ویدیویی از کرج به ایراناینترنشنال به ساختوساز در پارک تندرستی فردیس اشاره میکند و میگوید مقصودشان از ساختوسا ز در این پارک چیست چکار میخواهند بکنند چندتا درخت برای این ساختوساز قطع کردند		
شهروندی با ارسال پیامی صوتی به ایران ه شدن یحیی سنوار	شهروندی با ارسال پیامی صوتی به ایراناینترنشنال با اشاره به کشته ش دن یحیی سنوار، رهبر حماس، خطاب به علمالهدی میگوید الان حزبالله و حماس فرماندهی ندارند، شما را برای فرماندهی قبول داریم  مالهدی نیاز دارد		
ویدیوهای منتشرشده در حالوش، روایت شهروندان از نشت گاز شهری	والوش، روایت شهروندان از نشت گاز شهری و آ نجشن به ۲۶ مهرماه است		
امی ضمن تبریک	کوری ی ح خ خوالد و گ   را  تروری  د ک  ، ب مظر وشش    ش شاوار شاشاشاشاش		
امی ضمن تبریک	کوری ی ح خ خوالد و گ   را  تروری  د ک  ، ب مظر وشش    ش شاوار شاشاشاشاش		
پلیس اسرائیل در شبکه اجتماعی ایکس ویدیویی را منتشر کرده که در	پلیس اسرائیل در شبکه اجتماعی ایکس ویدیویی را منتشر کرده که در آن کا روان انتقال جنازه یحیی سنوار، رهبر کشتهشده حماس، به مرکز پزشکی قان ونی اسرائیل دیده میشود		
شهروندی با ارسال ویدیویی به ایراناینترنشنال درباره پخش خبر کش	شدن یحیی سنوار، رهبر حماس، میگوید منتظر تایید شدن خبر آن بودیم بعدی، نوبت اونی باشد که در این سرزمین حکمرانی میکند		
نفتالی بنت، نخستوزیر پیشین اسرائیل در واکنش به کشته شدن یحی س	گفت پیام من به همه دشمنانمان این است اسرائیل هرگز فراموش نمیکند یهودیان هرگز فراموش نمیکنند		
آنتونی بلینکن، وزیر خارجه آمریکا، یحیی سنوار را مسئول کشتار هز	آنتونی بلینکن، وزیر خارجه آمریکا، یحیی سنوار را مسئولکشتار هزاران اسرائیلی، آمریکایی و شهروندان بیش از ۳۰ کشور خواند و گفت تصمیم او بر ای حمله هفتم اکتبر به اسرائیل پیامدهای فاجعهباری برای مردم غزه شتبلینکن گفت در نبود سنوار، جهان جای بهتری است		
های وحشتناک	نخستوزیر استرالیا، یحیی سنوار را معمار جنایته ست جهان خواند و گفت مرگ او یک لحظه مهم است و میتواند نقطه عطفی حیات ی در این درگیری ویرانگر باشد		
ستی خواند که مس	خواند که مسئول حمله وحشتناک هفتم اکتبر حماس به اسرائیل و مانعی بر س ر راه آتشبس غزه و آزادی بیقیدوشرط گروگانها بودبورل خواستار توق ف خشونتها، آزادی گروگانها و پایان رنج مردم فلسطین شد		
گزارش گلوبالنیوز از هکرهای جمهوری اسلامی آمریکا عوامل جمهوری	ئیات بیشتر در گفتوگو با مهسا مرتضوی، ایران اینترنشنال		
م اکتبر خوان	کتبر خواند و گفت اکنون زمانی آتشبسی است که فصلی تازه را در خاورمیا نه رقم بزندوزیر خارجه بریتانیا همچنین با بازماندگان حملههای حماس در هفتم اکتبر ابراز همدردی کرد		
جورجیا ملونی، نخستوزیر ایتالیا، با ابراز اطمینان از اینکه کشت	جورجیا ملونی، نخستوزیر ایتالیا، با ابراز اطمینان از اینکه کشته ش ند، خواستار آزادی فوری همه گروگانها، آتشبس فوری در غزه و بازسازی این باریکه شد		
کییر استارمر، نخستوزیر بریتانیا، یحیی سنوار را مغز متفکر مر	کییر الار  ،  وزی ای کش  ش ی سیی وار       ل لزوم آز ه گوگاوگ ا از الت ح  کاکی		
ناکارآمد کردن تحریمها توسط دولت بایدن جزئیات بیشتر درگزارش ا	ناکارآمد کردن تحریمها توسط دولت بایدن		
نتانیاهو جنگ هنوز تمام نشده و آزادی گروگانها وظیفه ما است ار	نتانیاهو جنگ هنوز تمام نشده و آزادی گروگانها وظیفه ما است ارتش اس صفایی، ایران اینترنشنال		
خ به پرسشی دربار	پادکست پاتریک بت دیوید در پاسخ ب  به هیچ وجه نمیتوانیم به طور کامل در چنین کاری وارد شویم اداره کنیم ترامپ گفت من خواهان این هستم که ایران بسیار موفق شود		
برنامه با کامبیز حسینی ۲۶ مهر  ۱۴۰۳  ۱۷ اکتبر	برنامه با کامبیز حسینی ۲۶ مهر  ۱۴۰۳  ۱۷ اکتبر نسخه صوتی برنامه با کامبیز حسینی گفتوگو با نوشابه امیری روزنامهنگار و گوینده		
ز کشته شدن دیده	شته شدن دیده میشود		
امانوئل مکرون، رییس جمهوری فرانسه، مرگ سنوار را فرصتی برای آزا	ائل مک ، یی جمهو ، مرگ گ سوار  بی وی آزای گروگا  و گ ورگی از م دوض  ی دهد ای و ز الله ال او ازود ریش  ول د  ، ا  ک ی ای طو ط ط ط ط  نیابتی خود سالها انجام داده است		
ماس با بنیامین	در  وزی  دور ور وا ال ک کو بو  در ت یامی  الیاو کشه  در ایواوه آ ک  تواق ک اکووو فرص د ی وه تاق آزای گوگا و ورای ای  یکیک همکاری خواهند کرد		
ه فاکسنیوز گفت	تاکید شاهزاده رضا پهلوی بر توانمندسازی مردمشاهزاده رضا پهلوی به فا کسنیوز گفت دیپلماسی با جمهوری اسلامی شکست خورده استبررسی بیشتر ای نموضوع در گفتوگو با فرج سرکوهی، نویسنده و روزنامهنگار و نوید محب ی، تحلیلگر سیاسی		
تی برای پایان	میو  ،  ،ی وزارت خارج آمریکا ، کش  شویی ی س س س س سرا ف پایا دادوه جگ خواو و  کورش دارد طرح آش و آزای گوگاوگها پیش پیش ب ب  ازود ه ف ی اخی از مذاکره امت		
تیم فوتبال چادرملو در حالی در هفته هشتم رقابتهای لیگ برتر	ورزش سه ویدیویی از شادی تماشاگران زن چادرملو پس از گل این تیم منتشر کرده است		
تیم فوتبال مس رفسنجان در هفته هشتم رقابتهای لیگ برتر فوتب	ایرال  لال خ زال شک خورد تا پایال اولی زی  ضور  ویا ، چ  چهارده جول ق گی  ن هفته، چادرملو یزد در دیداری خانگی با یک گل خیبر خرمآباد را شکست د اد و به رده ششم جدول صعود کرد خیبر هم با این نتیجه در رده سیزدهم جای گرفتهمچنین شمسآذر قزوین تساوی ۱۱ رسید تا در رده یازدهم جدول جا ی بگیرد		
ویدیوهای منتشرشده در خبرگزاری فرانسه، برخی آثار نمایشگاه جدید	ویدیوهای منتشرشده در خبرگزاری فرانسه، برخی آثار نمایشگاه جدید موز ه لوور پاریس را با عنوان شکلهای دیوانه از قرون وسطی تا رمانتیک نشان میدهدبه گفته مسئولان موزه، موضوع ای نمایشگاه، جنون به عنوان یک بیماری روانی نیست بلکه حضور این نوع شخ صیتها را در هنر و فرهنگ غرب نمایش میدهد		
نتانیاهو یحیی سنوار حذف شد نور بر تاریکی غلبه خواهد کرد باید	نتانیاهو یحیی سنوار حذف شد ور تاریکی غ خواهد کرد وایو ای ی ی الائیل ، آمریکا جها ا ک سیخ سییخ آمریکا وه وه الائیل ی ر  ال حما جمل سوار کمک ک		
ریستی حماس خو	وزیارجه فرال  کش   ازود ار  ماورای صلح ود		
با اسرائیل در	است او افزود جو بایدن درخواست میکند که به طور مرتب در مورد توطئههای		
سمیرا قرایی، ایران اینترنشنال کشته شدن سنوار یک پیروزی برای ن	س قرایی، ای ایشال کش  ش یکواوزی ی   ال و ت   م  گذشه ایالات د    ور ده ک ذ   ات آآ در غز  یچ  د اگر سوار زوماو دال آمریکا  که ب ب  از سوار            به کجا میرسد		
۲۴ با فرداد فرحزاد	۲۴ با فرداد فرحزاد		
یحیی سنوار، ره	کامالا هریس، معاون رییس جمهور ایالات متحده، با اشاره به کشته شدن یح یی سنوار، رهبر حماس، گفت عدالت به اجرا درآمداو افزود دستگاه اطلاعا تی آمریکا برای یافتن سنوار همکاری نزدیکی با اسرائیل داشت		
دیانای تایی	انای تایید کرده که یحیی سنوار مرده است و این روز خوبی برای اسرائ یل، ایالات متحده و جهان است		
دیانای تایی	انای تایید کرده که یحیی سنوار مرده است و این روز خوبی برای اسرائ یل، ایالات متحده و جهان است		
سمیرا قرایی، ایران اینترنشنال کشته شدن سنوار یک پیروزی برای ن	س قرایی، ای ایشال کش  ش یکواوزی ی   ال و ت   م  گذشه ایالات د    ور ده ک ذ   ات آآ در غز  یچ  د اگر سوار زوماو دال آمریکا  که ب ب  از سوار    ا  ضو به کجا میرسد		
نماینده نروژ در یک نشست اتحادیه بینالمجالس گفت سرویس اطلاعاتی	نماینده نروژ در یک نشست اتحادیه بینالمجالس گفت سرویس اطلاعاتی ای ن کشور اعتقاد دارد جمهوری اسلامی پشت حملات تروریستی اخیر علیه سفارت   ن حملات معرفی کردهاندگزارشی از مجتبا پورمحسن		
بنیامین نتانیاهو، نخستوزیر اسرائیل، در یک پیام ویدیویی ضمن تا	نتانیاهو، نخستوزیر اسرائیل، در یک پیام ویدیویی ضمن تائید کشتهشدن یحیی سنوار، رهبر نظامی حماس، در عملیات نظامی اسرائیل، گفت    اینترنشنال گزارش میدهد		
بر اساس ویدیوهای منتشرشده در رویترز، ده قورباغه از یک گونه در	ا  ویوهای ملشش د قور ز یک  گال ال وه وه ولواو قم ی وردالشا ب ط خود در روخاوخ ی در ص آاماما ، ب یک م م مرکز   د شلی شیلی ملق شق غ آ که  ال    زی گرفته شده، به دلیل خشکسالی در معرض خطر انقراض قرار گرفته است		
بنیامین نتانیاهو در پی کشته شدن یحیی سنوار در پیامی خطاب به سا	بنیامین نتانیاهو در پی کشته شدن یحیی سنوار در پیامی خطاب به ساکنان غزه گفت سنوار زندگی شما را تباه کرد او شما گ شی  ک کرد ک		
وزارت خارجه آلمان سنوار یک قاتل و تروریست وحشی بودکه میخواست	اسر ائیل و مردم آن را نابود کند    بیحد و اندازه را برای کل منطقه به ارمغان آورد		
ر، او را اَبَر	او را اَبَر تروریست و مغز متفکر حمله هفتم اکتبر خواند و گفت سنوار بر ای سالها مسئول اعمال شنیع تروریستی علیه شهروندان اسرائیلی و شهرون    از مردم بیگناه بود		
کاظم موسوی، رییس کل دادگستری قم، رعایت حجاب و عفاف در این اس	کاظم موسوی، رییس کل دادگستری قم، رعایت حجاب و عفاف در این استان را مسئلهای مهم خواند و گفت ما به این موضوع توجه ویژه داریم قم، به عنوان مرکز علم و دین، نمیتواند از این موضوع غافل بماند و ما		
دن یحیی سنوار،	یوآو گالانت، وزیر دفاع اسرائیل، روز پنجشنبه با اشاره به کشته شدن یحیی سنوار، رهبر حماس، گفت که اسرائیل حساب طولانیمدت خود با او را ت صفیه کرده استاو افزود کشته شدن سنوار پیامی به همه دشمنان ماست و کسان ی که میخواهند به ما ضربه		
اردوان روزبه، ایران اینترنشنال کشته شدن یحیی سنوار، جمهوری اس	اردوان روزبه، ایران اینترنشنال کشته شدن یحیی سنوار، جمهوری اسلامی را وادار به پاسخ مستقیم به اسرائیل خواهدکرد		
اسرائیل و شاباک در بیانیهای مشترک خبر کشته شدن یحیی سنوار را	مشترک خبر کشته شدن یحیی سنوار را به صورت رسمی تایید کردند بنیامین نتانیاهو تا دقایقی دیگر در این باره کنفرانس مطبوعاتی برگزار خواهد کردگزارش اشکان صفایی، ایران اینترنش نال		
حسن هاشميان، تحلیلگر جهان عرب اهمیت یحیی سنوار برای اسرائیل	حسن هاشميان، تحلیلگر جهان عرب اهمیت یحیی سنوار برای اسرائیل به ا ندازه اهمیت آزادی گروگانهای اسرائیلی در اسارت حماس بود		
کشتهشدن یحیی سنوار جزئیات بیشتر در گزارش	کشتهشدن یحیی سنوار		
واکنش مقامات و رسانههای آمریکا در ایالات متحده به کشته شدن ی	سنوار یک مقام آمریکایی بایدن از راستیآزمایی در مورد قتل سنوار مطلع شدگ زارش مریم رحمتی، ایران اینترنشنال		
نوار، رهبر حما	ر، رهبر حماس، را تایید کرد		
بردیا افشین، ایران اینترنشنال در ابعاد بینالمللی هنوز این با	بردیا افشین، ایران اینترنشنال در ابعاد بینالمللی هنوز این باور ب ه وجود نیامده است که سنوار کشته شده است البته تمامی شواهد حکایت از، کشتهشدن و از بین رفتن سنوار دارد با مرگ او ابهاماتی مانند وضعیت جنگ در غزه، وضعیت گروگانهای اسرائ یلی و در جامعه بینالمللی مطرح میشود		
گزارشها و اخبار از کشته شدن یحیی سنوار و واکنشها به آن د ر ا	آخرین گزارشها و اخبار از کشته شدن یحیی سنوار و واکنشها به آن در ا سرائیلوبسایت والا نیوز اسرائیل به همراه جنازه سنوار، پول، سلاح و وسایل انفجاری پیدا شده استگزارش اشکان صفایی، ایران اینترنشنال		
نوار، مسئول	ی کاز، وزی الائیرائیل ، ،ی ی الد ککی سیی ، م مار و جو ج ات هف اک ،روز پ د س الائیلی کش  شه ال		
پس از ممنوعیت حضور تماشاگران زن در بازیهای خانگی آلومینی	ایرال ایتشورزشیپ وورزشیپ  ض ضور تماش ز ب ی آلومی آ پی ی ح در اایایوم اراک، از از گذش چ ماه ،اشگلومیوم ا  بووه و فول   حاضر شونددر اطلاعیه آلومینیوم آمده با فراهم شدن زیرساختهای لا زم توسط باشگاه آلومینیوم اراک و اخذ مجوزهای لازم از مراجع ذیربط، ه واداران زن میتوانند در دیدار تیمهای آلومینیوم و فولاد خوزستان، ر ورزشگاه اراک حضور پیدا کنندآخرین بار هواداران    زشگاه حاضر شده بودند		
اتلتیک گزارش داده پپ گواردیولا، سرمربی تیم فوتبال منچسترسی	گزارش داده پپ گواردیولا، تیم فوتبال منچسترسیتی، برای تمدید قرارداد خود منتظر مشخصشدن نتیجه پرونده اتهامات باشگاه است اما برخلاف تصورات، درصورتی که سیتیزنها محکوم شوند، احتمال ترک باشگاه توسط پپکمتر خواهد بوداتلتیک دراین باره   ک گواریولا  ش ش ، قد ک کور  ش ش و  ازایش  اق ا  او تا حی وه دلیل  از مکومی احمالی  تا حوی لیل ای که ت شوار ا  آ  آ  ییوا  ز ککی و  حال خوش  است تا حکم پرونده صادر شده و گواردیولا در نهایت به ماندن فکر کند، ام     گواری ولی ماد      ومایل افراد ا ر  مرات ی اهی وم  ر خوش ی پیش		
پس از اظهارات انتقادی امیر قلعهنوی، سرمربی تیم ملی در نشس	ایرال ایشور ورزشیپ از ار ت الق امی قلویی، سویی، د در  خ پ  های پرکوه او خطال وه وه وه ققااور یک بو ص صامروز تل ، جواد خیا ج مج گفت تیمت قطر را برده، جام جهانی را که فتح نکرده چرا باید این حمله و هجمه به یک برنامه تلویزیونی بشود		
هان کانگ، نویسنده برنده جایزه نوبل ادبیات، در یک سخنرانی گفت	کالگ،  د  جایز   ادات یک یک خ ی گ وق اولی  خ د جایز  ولا از ن د ت کردم ، واق		
مسعود فلاحی، جانشین فرمانده سپاه ولیعصر خوزستان، با تاید بر ا	د فلای، جالشی ف  ولی  خوزوز ، تای و هی جالال و کاو خالواد گ   ی اگر  شود		
پلیس اسرائیل هویت جسد سنوار از روی تصاویر دندانهایش شناسایی	پلیس اسرائیل هویت جسد سنوار از روی تصاویر دندانهایش شناسایی شدسم یرا قرایی، ایران اینترنشنال گزارش میدهد		
باکشته شدن سنوار چه تغییراتی در عملکرد حماس و ارتباط اینگروه ب	با کشته شدن سنوار چه تغییراتی در عملکرد حماس و ارتباط این گروه با اس  پژوهشکده ممری		
ویدیوی قدیمی از حضور یحیی سنوار، رهبر کشته شده حماس در ایران و	ویوی ققمی از ضور ی سیی سوار ، ر  کشه  حما در ایراو و   با خام ای مل ش ک    ه  کش   ح  ر را د ۲۰۱۱ میلادی بوده است		
کانال ۱۲ اسرائیل با انتشار جزئیاتی از مرگ یحیی سنوار نوشت که ن	کانال ۱۲ اسرائیل با انتشار جزئیاتی از مرگ یحیی سنوار نوشت که نیروها ی ارتش از حضور رهبر حماس در ساختمانی که به آن حمله کردند، اطلاعی نداش تند گفتوگو با بابک اسحاقی، ایراناینترنشنال		
متعلق به یحیی	پلی اس ئی  ک پیا شه از یک پ از درگی د ی سیی وار ، ر ، ر   شا شه ا		
سنوار میگوید	ار میگوید		
محمدباقر قالیباف، رییس مجلس در اجلاسیهای با عنوان مجاهدان در	محلد قالیف ، ریی مجوو اجلای ی وا  د گ گا در مرکز کومت خود ش شح خوا		
اهمیت کشته شدن یحیی سینوار بر آینده جنگ غزه و واکنشها در ایال			
رادیو ارتش اسرائیل کشته شدن یحیی سینوار، رهبر حماس را تایید کر	ارتش اسرائیل کشته شدن یحیی سینوار، رهبر حماس را تایید کرد د کرده است جزئیات بیشتر در گزارش بابک اسحاقی، ایران اینترنشنال		
رادیو ارتش اسرائیل یحیی سنوار، رهبر حماس، در رفح کشته شد گفت	ا علیحسین قاضیزاده، ایران اینترنشنال		
کشته شدن یحیی سنوار، رهبر حماس چه تاثیری بر مذاکرات اسرائیل و	کشته شدن یحیی سنوار، رهبر حماس چه تاثیری بر مذاکرات اسرائیل و حماس خواهد گذاشتگفتوگو با مئیر جاودانفر، تحلیلگر مسائل اسرائیل		
میری است روزنا	مهمان امشب در پنجشنبهی ویژه برنامه با کامبیز حسینی، نوشابه امی ری است روزنامهنگار و گویندهی شناخته شدهی ساکن پاریس نگاری کودکان دهههای شصت و هفتاد استبرای شرکت در برنامه و گفت وگو با نوشابه امیری به واتساپ و تلگرام ما پیام بفرستید تا لینکشرکت برایتان ارسال شود تلفن برنامه۰۰۴۴۷۵۱۰۱۱۰۱۱۰		
اخت قسمتی از و	حمیرضا دالایی، دوو ج فرهگی القلا تهرا گ  پرداخ قاز وجوهات شوجو ش ما ق ، ب باشاش  ش ش		
بهروز سلمیان، طبیعتگرد، ویدیویی منتشر کرده که حضور یک شوکا ر	روز  ، ط ط ، ویویی ش ک کور یکوکا رر جر جل    را یال   د   کوچک گ گوز ایرال ا		
ارتش اسرائیل اعلام کرد در جریان عملیاتی در غزه سه تن از نیروها	س کشته شدند و ارتش به همراه آژانس امنیت اسرائیل در حال بررسی این احتم ال هستند که یکی از این افراد یحیی سنوار، رئیس دفتر سیاسی حماس باشدبا بک اسحاقی، ایران اینترنشنال گزارش میدهد		
ر حال انتقال جس	یورکای چ ز چهار مقام الائیوش ارش ای کشور کشال ش ج ج ج ش ش ب   آزماه ال ی بد آی  ای آ ی وار مط  دارد همچنین به نقل از مقامهای آمریکایی نوشت اسرائیل به واشینگتن خبر دا ده که نیروهایش احتمالا یحیی سنوار را کشتهاند		
یل نسبت به هرگ	گفت که این کشور به اسرائیل ن ت او افزود به اسرائیل هشدار دادیم که حمله به تاسیسات هستهای تنشها را به حد خطرناکی خواهد رساند و هرگونه ایمنی هستهای را از بین خواهد برد		
یمیا قربانی، ای	القال پ ویا از ایالیا  اروگاه پاهجویال آ آ یکیا ق یورا ایتال کوکاو ز و یشود		
پس از هفتهها انتظار ولودیمیر زلنسکی از طرح پیروزی اوکراین رو	پس از هفتهها انتظار ولودیمیر زلنسکی از طرح پیروزی اوکراین رونما یی کرد طری که وه وه او رق ص  صارار الیا اشی ، ایورالش پیپیپیپیپیپیپیپیپیپیپیپیپی		
در خبری فوری، ارتش اسرائیل با انتشار بیانیهای تائید کرد تحقیق	در خبری فوری، ارتش اسرائیل با انتشار بیانیهای تائید کرد تحقیقات د ر مورد احتمال کشته شدن یحیی سنوار، رهبر حماس در حمله اخیر به رفح را ا		
زلنسکی روسیه دارد حدود ۱۰ هزار سرباز از کره شمالی را برای جنگ	زلنسکی روسیه دارد حدود ۱۰ هزار سرباز از کره شمالی را برای جنگ علیه ما آموزش میدهد، او افزود، این قدم اول به سمت یک جنگ جهانی است		
پیمان جبلی، رییس صدا و سیما با اشاره به اینکه دسترسی به جامعه	اشاره به اینکه دسترسی به جامعه عبری ز بان ساکن در اسرائیل پیچیدگیهای خاص خودش را دارد، گفت ما قطعا به بال افزایش برد، نفوذ و ضریب تاثیر رسانهای در فضای داخل اسرائیل هست یم		
داد کرد	کرد که ارتش و شین بت در حال بررسی این احتمال هستند که یکی از ک		
که بامداد پنجشن	کرده که بامداد پنجشنبه ۲۶ مهرماه تاسیسات زیرزمینی تسلیحات حوثیهای یمن را ختگیری در آسمان میبینید		
سفر بایدن به آلمان باچه هدفی انجام میشود احمد صمدی، ایران ای	شنال گزارش میدهد		
ویدیوهای منتشرشده در خبرگزاری فرانسه دو انفجار بزرگ را در نزدی	ویدیوهای منتشرشده در خبرگزاری فرانسه دو انفجار بزرگ را در نزدیکی		
داستان ساز و گلدون در صداوسیما بعد از اینکه صداوسیما بابت پ	داستان ساز و گلدون در صداوسیما بعد از اینکه صداوسیما بابت پخش صدا ی یک خوانندهی زن عذرخواهی کرد، ما تصمیم گرفتیم وضعیت موسیقی در صدا وسیما از جمله گلدان گذاشتن جلوی ساز را بررسی کردیم این شما و این داستان ساز و گلدوننسخه کامل برنامه در یوتیوب		
حتمالی اسرائیل	مالی اسرائیل به جمهوری اسلامی، یک بار دیگر اسرائیل را به اقدام متقاب ل تهدید کرد و گفت جمهوری اسلامی در هدف قراردادن اسرائیل تعارف ندارد گفتوگو با مرتضی کاظمیان، ایران اینترنشنال		
در اجلاس سران اتحادیه اروپا، ولودیمیر زلنسکی را ارائه کرد ک ه	در اجلاس سران اتحادیه اروپا، کرد که ب به پایان خواهد رسیدمصدق پارسا، ایران اینترنشنال گزارش میدهد		
وودوارد، خبرنگار شناختهشده آمریکایی، در کتاب جدید خود با ع نو	باب وودوارد، خبرنگار شناختهشده آمریکایی، در کتاب جدید خود با عنو ان جنگ جزئیات تازهای از تصمیم جو بایدن درباره خروج از افغانستان		
بودجه از سوی دول	را د ای اد از احمال اقا  تورمزا ج ج ک  صای		
اولاف شولتز، صدراعظم آلمان جمهوری اسلامی با آتش بازی میکند ج	اولاف شولتز، صدراعظم آلمان جمهوری اسلامی با آتش بازی میکندجزییا ت بیشتر با احمد صمدی، ایران اینترنشنال		
ویدیوی منتشرشده در خبرگزاری فرانسه ارسال محمولههای کمکی از طر	ویدیوی منتشرشده در خبرگزاری فرانسه ارسال محمولههای کمکی از طریق هواپیما را در خانیونس غزه نشان میدهدرییس آژانس آوارگان فلسطینی سازمان ملل در خصوص خطر قحطی در غزه هشدار داده و آمریکا اعلام کرده به اسرائیل نسبت به بهبود ارسال کمک به این منطقه هشدار داده شده است		
که اهل سنت نه	صد دارند تخم تفرقه را در کشور بپاشند، نگذرد آنهایی که به اسلام خیانت میکنند همه ما پای انقلاب خود ایستادهایم		
وزیران دفاع آمریکا و اسرائیل در تماسی تلفنی درباره درگیریهای	وزیرال آمریکا و الائیول تومای تل د د درگیهای ائیل و ززالل  ، الار    د ت یروهای حاظ صلح   مل گوگوگوگوگوگوگوگوگوگوگوگوگوگوگوگوگوگوگوگوگوگوگوگوگوگوگوگوگوگ ا اقی،رال ایش آخری تولات ج		
در روز دوم اجلاس سران اتحادیه اروپا، علاوه بر بحران انسانی و ت	ای خاورمیانه، موضوع حمایت از اوکراین نیز از مباحث کلیدی بودمصدق پار سا، ایران اینترنشنال گزارش میدهد		
امیر قلعهنویی، سرمربی تیم ملی فوتبال، در ارتباط تلفنی با	وانم جواب خیلیها را بدهم، تاج از من خواسته سعه صدر داشته باشم ولی ی ک روزی میآیم در تلویزیون گذشته تک تک سرمربی گفت الان در بعضی شبکهها تریبون فقط به افرادی داده میشود که بدی ر قلعهنویی ضدیت داشته باشند رزومهشان، ضدیت با قلعهنویی است من ده سال است به این مدل رفتارها عادت دارم گلگ  زما   را پاری کر قایه ک قلوییویی یگ و   رئی صاو  بای آق با ب س ق ی یش آمد  ، ا  ال موارد یگر اگر قرار است درباره یک نفر صحبت کرد، درباره رزومهاش صحبت شود به هرکسی که نمیشود تریبون داد خطاب به جبلی و فروغی مدیر شبکه سه میگویم  جزئیات بیشتر را اینجا بخوانید		
۲۰ سال پیش در چنین روزی، لیونل مسی، فوقستاره آرژانتینی دن	ایرال ایتورزشی۲۰ ورزشی۲۰ پیش چور چوزی، لی   ف آ آرژاویی دیای فوتوتوتوت از  زی  پیراه را ج کرد۱۰ ق ی لالا ، ۴ ۴ ق ق  ا اوپا ۷ کوپادل ۷ سوپرکاپ اسپانیا، ۳ سوپرکاپ اروپا و ۳ جام جهانی باشگاهها، حاصل د بارسلونا بود		
علیرضا دبیر، رئیس فدراسیون کشتی، در جمع ملیپوشان درباره ب	کشتی گفت ای کاش سال پیش به حرف ما گوش میداد و جایی که ما گفتیم عمل میکرد گش او پ پ پ ارا ک یک یک ب خرا کشگکش گ  ا  دورای ا   و کرد بلی جلوت خیلی جلی او حتما به امید خدا باید برسد او راحت میتواند ۴ سال دیگر کشتی بگیرد جوری نشود مثل من که در ۲۵ سالگی با دست خراب رفتم و کسی حالم را نپرسید بشود یک مملک ورای ح یزالی  ف در ای چطور بوده است، یا تاج الدین اف و جمال اف هم همینطور عمل کتف کشتی گیر مثل مچ پای فوتبالیست است پزشک خیلی اثرگذار است و من فعلا نمیگویم چطور عمل شده است چرا که حا شیه میشود ما در خیلی حوزهها دکتر خوب داریم من بارها گفتم، اما به دوستان برخورد همه چیز غرب بد نیست که		
احمد دنیامالی، وزیر ورزش و جوانان پس از بازدید دوباره از ف	ایرال ایشورزشیاحمد دی، الی، ورزش و و جو وا پ ب دو  از ف جر جم گ گ گ ک ک ک ک ک ک ک ک کک ر فرای ی ورزشی وو		
منصور شادکام، قائممقام انجمن نابینایان در گفتوگو با دیده ب	ایران گفت نابینایان دوست ندارند آنها را روشندل خطاب کنند همان نابینا کلمه مناسبی استاو افزود آموزش و پرورش نابینایان را ازی نشده است		
پسکوچه  قبل از استفاده از هر سرویس، بررسی سند حریم خصوصی ضرو	پسکوچه  قبل از استفاده از هر سرویس، بررسی سند حریم خصوصی ضروری است تا بدانید اطلاعات شما چگونه جمعآوری و استفاده میشود		
لیام پین، خواننده مشهور بریتانیایی و عضو سابق گروه وان دایرکشن	لیام پین، خواننده مشهور بریتانیایی و عضو سابق گروه وان دایرکشن روز چهارشنبه ۲۵ مهرماه پس از سقوط از بالکن اتاقش در طبقه سوم هتلی در بوئن وس آیرس آرژانتین درگذشت پلیس پیش از این اتفاق به کند که ب		
ویدیوی منتشرشده در رسانهها نشان میدهد روز پنجشنبه ۲۶ مهرماه	عبا ی خامنهای همراه با جنازه عباس نیلفروشان، فرمانده کشتهشده سپاه در بیروت خاک شده است		
با ادامه درگیری میان اسرائیل، حماس و حزبالله، شرایط آوارگان د	با ادامه درگیری میان اسرائیل، حماس و حزبالله، شرایط آوارگان در خا ورمیانه به بحرانی انسانی و نگرانکننده تبدیل شده استگزارش مهسا مرت ضوی، ایران اینترنشنال		
قرار داده است با	قرا ر داده استبابک اسحاقی، ایران اینترنشنال گزارش میدهد		
با ادامه درگیری میان اسرائیل، حماس و حزبالله، شرایط آوارگان د	با ادامه درگیری میان اسرائیل، حماس و حزبالله، شرایط آوارگان در خا ورمیانه به بحرانی انسانی و نگرانکننده تبدیل شده استگزارش مهسا مرت ضوی، ایران اینترنشنال		
سرخط خبرهای پنجشنبه، ۲۶ مهر	سرخط خبرهای پنجشنبه، ۲۶ مهر		
میمی برای برای	موسی احمدی، رییس کمیسیون انرژی مجلس، گفت که در دولت و مجلس هیچ تصمی می برای برای کاهش یا افزایش سهمیه بنزین و قیمت آن گرفته نشده است ا ازود  و مردم واققی ی کشور حوزوزه الژی و  گ  آ  گرف شود		
سیستمهای ذخیرهسازی آب، یکی از شاخصهای مهم تمدن برای شهرهای	سیستمهای ذخیرهسازی آب، یکی از شاخصهای مهم تمدن برای شهرهای تا ریخی محسوب میشود آبانبار ۱۵۰۰ ساله باسیلیکا در استانبول، برای تامین آب کاخ امپرات وری بیزانس ساخته شدگزارشی از فرزیا ثابتی، ایران اینترنشنال		
کره جنوبی گزارشها درباره اعزام سربازان کره شمالی به روسیه بر	کره ج  گزارشها د ا  کال کره شمالی وه رای  جوک اوکرایر دا و و ت ا ز، ط ط ط ط ط  یرال ایتوو گزارش		
دولت استرالیا از اهدای ۴۹ تانک زرهی آبرامز به ارتش اوکراین خبر	دولت استرالیا از اهدای ۴۹ تانک زرهی آبرامز به ارتش اوکراین خبر داد جزئیات بیشتر با علیرضا محبی، ایران اینترنشنال		
آیدا شاکرمی، خواهر نیکا شاکرمی، از بازداشت مادرش، نسرین شاکرمی	آیدا شاکرمی، خواهر نیکا شاکرمی، از بازداشت مادرش، نسرین شاکرمی در خرمآباد خبر دادگفتوگو با آزاده دواچی، فعال حقوق بشر و زنان		
آیدا شاکرمی، خواهر نیکا شاکرمی، از بازداشت مادرش، نسرین شاکرمی	آیدا شاکرمی، خواهر نیکا شاکرمی، از بازداشت مادرش، نسرین شاکرمی در خرمآباد خبر دادگفتوگو با آزاده دواچی، فعال حقوق بشر و زنان		
بر اساس ویدیوی منتشرشده، حسین سلامی، فرمانده کل سپاه روز پنجشن	بر اساس ویدیوی منتشرشده، حسین سلامی، فرمانده کل سپاه روز پنجشنبه ۲ ۶ مهرماه در مراسم تشییع عباس نیلفروشان، کشتهشده سپاه بی روت، خطاب به اسرائیل گفت به تادها اعتماد نکنید شما نمیتوانید قتلعام کنید اما ایمن بمانیداشاره او به سیستم پدا فند هوایی تاد است که به تازگی آمریکا برای اسرائیل ارسال کرده است		
چهار کشور اروپایی، شکایت تازهای در رابطه با سرنگونی هواپیمای	چهار کشور ا  ایی، شکای تازاز د    هواپی اوکی   پ پا ،  ،واو  حا  ال  لیول ، و هیئ میره الجم داخوا پوازوکی د ق پوقیوقیوقیوقیوقیوقیوقیوقیوقید		
بعد از اینکه صداوسیما بابت پخش صدای یک خواننده زن عذرخواهی ک	بعد از اینکه صداوسیما بابت پخش صدای کرد، ما تصمیم گرفتیم وضعیت موسیقی در صداوسیما، از جمله گلدان گذاشتن جلوی		
کشورهای عضو شورای همکاری خلیج فارس و اتحادیه اروپا، در بیانیه	کشورهای عضو شورای همکاری خلیج فارس و اتحادیه اروپا، در بیانیهای م  با حسین آقایی، پژوهشگر امور استراتژیک و روابط بینالملل		
نیلفروشان که به	لفروشان که به همراه حسن نصرالله کشته شد، خطاب به اسرائیل گفت مراقب کنید شما را دردناک خواهیم زد		
شاتر  مروری بر آثار هنر اعتراض	شاتر  مروری بر آثار هنر اعتراض		
مدیر پالایشگاه پتروپارس شوشتر میگوید، ۷۰ درصد از مخازن و ماشی	پالایشگاه پ شوش ، ۷۰ د خ و  ماشیلات آ ز ول رف ا الرژی		
جرهای حزبالل	روی گزارشی، و جزئیای تاز از  اجرای یات ار پیج پوه ال ا  یش شکریا شگ شگ المل و  خارجی		
جنگندههای آمریکا و بریتانیا به چند هدف حوثیها در صنعا و صعده	هکردند ال میگوی ، الات مته ر اولی ومله وملا  رادارگ ال داده ا لیلگ جهال عر		
ویدیویی به ایراناینترنشنال رسیدهکه شعارنویسی دختراندانشآم وز	که شعارنویسی دختران دانشآموز بریز نشان میدهد اما دوب اره نوشتیم		
پیامی به ایراناینترنشنال رسیده که در آن شهروندی در اشاره به س	پیامی به ایراناینترنشنال رسیده که در آن شهروندی در اشاره به سیاست دوگانه جمهوری اسلامی در حمایت از نیروهای نیابتیاش میپرسد اگر آز  د		
لوید آستین، وزیر دفاع آمریکا، در بیانیهای گفت حملههای ارتش ا	ارتش ایال   متحده میتواند به این اهداف دسترسی داشته باشدوزیر دفاع آمریکا گفت به در		
رک نشست پایانی	کشورهای عضو شورای همکاری خلیج فارس و اتحادیه اروپا در بیانیه مشترک نشست پایانی خود از ایران خواستند به اشغایر سهگانه ایرانی تنب بزرگ، تنب کوچک و ابوموسی پایان دهد نقض		
موتورز را در روز	ویدیویی به ایراناینترنشنال رسیده که تجمع مالباختگان شرکت فردامو تورز را در روز چهارشنبه ۲۵ مهر مقابل این شرکت نشان میدهد		
فاکس نیوز، دیپل	کس نیوز، دیپلماسی و مذاکره با جمهوری اسلامی را شکست خورده دانست و عین حال گفت که جنگ نیز راه حل نیست بلکه در عوض، باید راه سوم، یعنی توا نمندسازی مردم ایران را برگزیداو گفت من همیشه گفتهام که بهترین راه برای کمک به مردم ایرا ن برای رهایی از این رژیم، حمایت و توانمندسازی آنهاست ما دیدهایم که دیپلماسی شکست خورده و جنگ هم راهحل نیست تنها راه سوم باقی میماند و آن این است که برای اولین بار در چهار دهه گذشته بر روی مردم ایران سرمایهگذاری کنیم، به جای اینکه وقت خود را برای مذاکره با این رژیم تلف کنیم  ت		
حزبالله نوشت ع	کی و یک مواد منفجره جدید بود که با اشعه ایکس قابل کشف نبودهاند سه خبرنگار رویترز، که باتریهای آلوده این پیجرها را دیدهاند با ن گزارش تحقیقی نشان دادهاند چگونه دستگاه امنیتی اسرائیل با ستفاده از یک چاشنی نامرئی و مواد منفجره پلاستیکی نازک، باتری پیجره ا را به بمب تبدیل کردندبنا بر این گزارش، باتریهای داخل پیجرهایی که در آغاز سال جاری میلادی به لبنان رسیدند، بخشی از اقدامات اسرائیل نابودی حزبالله بودندبه گفته یک منبع لبنانی که اطلاعات دست او دند که یک بار کوچک اما قوی از مواد منفجره پلاستیکی و یک چاشنی جدید که برای اشعه ایکس نامرئی بود، در گزارش خود تاکید کرده که اسرائیلیها ن باتریها راکه به خاطر مواد انفجاری داخل آن، به شکلی غیرمعمول برای پیجرها بزرگ بودند، برای این عملیات طراحی کرده بودند		
یالاتمتحده علی	فر ف  م ، ،  ، ، پول  ۲۶ م مهر ا  ک کالا  عا تال  زی ت اوثیو ج ی الامی چی  الجام و و ور  ر ا     سرخ، خلیج عدن و سایر نقاط منطقه میشدارتش آمریکا با اشاره ه استفاده از بمبافکنهای رادارگریز بی۲ اسپیریت در این حملهها گفت استفاده از این بمبافکنها نشانگر توانایی تها جمی آمریکا در حمله به اهداف مورد نظر خود در هر زمان و مکان لازم است سنتکام خاطرنشان کرد بررسیها نشان میدهد در حملههای آمریکا به ح وثیهاغیرنظامیان آسیب ندیدهاند		
ویدیویی که جعفر پناهپور، و تصویربردار حیاتوحش، در اینست اگرا	ویدیویی که جعفر پناهپور، عکاس و تصویربردار حیاتوحش، در اینستاگ رام منتشر کرده، دویدن قوچهای اوریال را در پارک ملی گلستان نشان می دهد		
حزبالله نوشت ع	کی و یک مواد منفجره جدید بود که با اشعه ایکس قابل کشف نبودهاند سه خبرنگار رویترز، که باتریهای آلوده این پیجرها را دیدهاند با ن وشتن یک گزارش تحقیقی نشان دادهاند چگونه دستگاه امنیتی اسرائیل با ستفاده از یک چاشنی نامرئی و مواد منفجره پلاستیکی نازک، باتری پیجره ا را به بمب تبدیل کردندبنا بر این گزارش، باتریهای داخل پیجرهایی که در آغاز سال جاری میلادی به لبنان رسیدند، بخشی از اقدامات اسرائیل گفته یک منبع لبنانی که اطلاعات دست او دند که یک بار کوچک اما قوی از مواد منفجره پلاستیکی و یک چاشنی جدید که برای اشعه ایکس نامرئی بود، در آن تعبیه شده بود		
پیمان جبلی، رییس سازمان صداوسیما، با اشاره به نظرسنجیهایی که	قط مرکز تحقیقات صداوسیما بلکه مراکز نظرسنجی معتبر دیگر هم انجام می هها و رسانهها از این مساله ناراحتند		
ادیه اروپا در م	وا  خارج  ، م م موض شورای خلیج فاو و ای  اتهامی پوچ خوالد و تاکی ک جزایر گاوه هموالق و ایرال و اورای  چ خواهد ماندعراقچی گفت این موضع نشان میدهد با وجود مذاکرات متعددی که م قامهای ایران و اتحادیه اروپا برگزار کردهاند، اروپا تمایل بهریک ردی تقابلی دارد او افزود دوره دخالت مخرب اروپا با شیوه تفرقه بینداز و حکومت کن، مدت کشورهای عضو شورای همکاری خلیج  د به اشغال جزایر سهگانه ایرانی تنب بزرگ، تنب کوچک و ابوموسی پایان دهد نقض		
عباس عراقچی، وزیر خارجه جمهوری اسلامی، در پایان سفر خود به ارد	ا  طریق    د تبادل پیام استفاده خواهد شد، هرچند روند مذاکرات هستهای با آمریکا ، موسوم به روند مسقط در حال حاضر توقف است		
جمهوری اسلامی در انزوای منطقهای و جهانی نیویورکتایمز جمهوری	جمهوری اسلامی در انزوای منطقهای و جهانینیویورکتایمز جمهوری اس کشورهایی مانند سوریه، یمن، لبنان و عراق استجزئیات بیشتر در گزارش اردوان روزبه، ایران اینت رنشنال		
ی روز سهشنبه ۲۴	محسن قلیزاده، مالک پالایشگاه پترو پارس شوشتر، گفت علت آتشسوزی ر وز سهشنبه ۲۴ مهر این پالایشگاه احتمالا انسانی بود و در این آتشسوز ی حدود ۷۰ درصد مخازن و ماشینآلات از بین رفتهاند قلیزاده ابراز امیدواری کرد تا دو ماه آینده خط اول پالایشگاه به تو لید بازگردد    د است		
ایبیسی نیوز چهارشنبه ۲۵ مهر به نقل از یک منبع اسرائیلی گزارش	نیوز چهارشنبه ۲۵ مهر به نقل از یک منبع اسرائیلی گزارش داد تعدادی از اهداف حمله تلافیجویانه اسرائیل به جمهوری می را به تایید رسانده است این منبع جزییات بیشتری ارائه نکرد و درباره اینکه آیا این اهداف صرفا نظامی هستند اظهارنظر نکرد		
ویدیویی که رسانههای داخلی منتشر کردهاند وضعیت پالایشگاه پار	کردهاند وضعیت پالایشگاه پارس پ ترو شوشتر را پس از آتشسوزی در روز سهشنبه ۲۴ مهر نشان میدهد به گفته محسن قلیزاده، مالک پالایشگاه، حدود ۷۰ درصد مخازن و ماشین		
مراد ویسی، ایران اینترنشنال هر کسی کمی اوضاع منطقه را پیگیری	مراد ویسی، ایران اینترنشنال هر کسی کمی اوضاع منطقه را پیگیری کرد ه باشد از این حجم تناقض در سیاست خارجی جمهوری اسلامی تعجب میکند همین اردن که عراقچی به آنجا سفر کرده است در طول عملیات وعده صادق یک و دو، جمهوری اسلامی دوبار بدون اجازه از آسمانش استفاده کرده است		
محسن پاکنژاد، وزیر نفت، در حاشیه هیات دولت در روز چهارشنب ه ۲	محسن پاکنژاد، وزیر نفت، در حاشیه جلسه هیات دولت در روز چهارشنبه ۲ ۵ مهر گفت شاید قصور نیروی انسانی در آتشسوزی در پالایشگاه پتروشوش تر در استان خوزستان نقش داشته است و افزود پالایشگاه در بخش غیردولتی بوده و به طور مستقیم ربطی به وزارت نفت ندارد		
در حالیکه تمام تمرکزها بر روی پاسخ اسرائیل به حمله موشکی جمهور	امی است		
مراد ویسی، ایراناینترنشنال هیچ کدامشان هم جرات نمی کنند به م	مراد ویسی، ایراناینترنشنال هیچ کدامشان هم جرات نمی کنند به مردم		
مراد ویسی، ایراناینترنشنال ایرانی هایی که ۴۶ سال است دست شما	مراد ویسی، ایراناینترنشنال ایرانی هایی که ۴۶ سال است دست شما گیر افتاده اند چه کار کنند		
سیاست با مراد ویسی  ۲۵ مهر  ۱۴۰۳  ۱۶ اکتبر	سیاست با مراد ویسی  ۲۵ مهر  ۱۴۰۳  ۱۶ اکتبرنسخه صوتی برنامه سیاست ب ا مراد ویسی پینگ پنگ موشکی اسرائیل و جمهوری اسلامی		
ان نسرین شاکرمی	آیدا شاکرمی، خواهر نیکا شاکرمی، در شبکههای اجتماعی نوشت مادرشان		
امشب در برنامه با کامبیز حسینی دربارهی فتوای خامنهای که گف	امشب در برنامه با کامبیز حسینی دربارهی فتوای خامنهای که گفته لا گفتوگو کردیم و بهش گفتیم نتر س لایک که ترس نداره		
برنامه با کامبیز حسینی ۲۵ مهر  ۱۴۰۳  ۱۶ اکتبر	برنامه با کامبیز حسینی ۲۵ مهر  ۱۴۰۳  ۱۶ اکتبر نسخه صوتی برنامه با کامبیز حسینی خامنهای گفت برنامه را لایک نکنید		
پیرحسین کولیوند، مدیرعامل جمعیت هلال احمر جمهوری اسلامی، با ا	کولیوند، مدیرعامل جمعیت هلال احمر جمهوری اسلامی، با اشار ه به اینکه از ۷۰۰ مجروح انفجار پیجرهای حزبالله در لبنان، ۵۰۰ بر ای درمان به ایران منتقل شدند، گفت در مجموع ۸۰ درصد این مجروحان از بینایی نجات پیدا کردند		
حمید رسایی، نماینده تهران در شبکه ایکس نوشت که مسعود پزشکیان د	های در پاسخ به سوال برخی نمایندگان دربارهچرایی ابقای محمدجواد ظری ف در گفته اگر او بیرون مانده بود، اپوز سیون ما کنترل میشود نزدیک پزشکیان، در پاسخ به رسایی		
جلسه گفتوگو با مریم رحمتی، ایرا ناینترنشنال	جلسه اضطراری شورای امنیت درباره غزهگفتوگو با مریم رحمتی، ایران اینترنشنال		
بیژن کیان، سخنگو و دبیرکل اندیشکدهی آوای آزادی اتفاق مرسومی	بیژن کیان، سخنگو و دبیرکل اندیشکدهی آوای آزادی اتفاق مرسومی است که اتاقهای فکر و کسانی که در زمینه سیاست خارجی و امنیت بینالملل و ریکا، پیشنهادان سیاست گذاری خودشان را به رئیس جمهور بعدی، تقدیم میکنند		
شاهزاده رضا پهلوی در گفتوگو با شبکه اسکاینیوز گفت فلسطی نیه	شا  رضا پهلوی د بوگو ش ش یایوز ر گل قققققومال ج ج ج ج ج ج اورای  یی ی خود الاده میکد او و وا ایک  ج و ب   وی الائی ، اسودو یومیخوالیخوا خود را آزاد کنند		
یل به جمهوری اسل	همزمان با درگیریها در غزه و لبنان و افزایش احتمال حمله اسرائیل ب ه جمهوری اسلامی، عباس عراقچی، وزیر خارجه ایران در ادامه سفرهای منطق های خود و گفتوگوها درباره این تنشها به قاهره سفر کرد سخنگوی وزارت خارجه گفت که در این سفر گفتوگوهای مهمی با مقامهای ارشد مصر انجام خواهد شد		
ها به تلویزیون ر	محسن برمهانی، معاون صداوسیما دلیل جلوگیری از بازگشت برخی چهرهها به تلویزیون را صحبت درباره همجنسگرایی عنوانکرد پیشر در مصاحیای   میز لی ضیا ، ج مجری پیشی صاو ، ، وروه  فری  دو یکو  وآو ش ار ار ار ار ار ار  ا ا و ها د		
ن سیاستمدار دمو	م جیمی کارتر ، متق ریی پیشی آ  ، ،ایی کورد ای یار د کوکرات اکو ۱۰۰ س دال ، رای خود ود ط ک کرد ا ال کارت گ او در زگی ه جمهوریخ  د وه ال   الگی، زنده ماندن برای رای دادن به کامالا هریس است		
تکذیب درگیری با مهاجران افغان از سوی ایران در اثر انفجار مین	ندازی دستکم یک نفر کشته و دهها مهاجر زخمی شدندبررسی بیشتر در گفت وگو با شاهد علوی، ایران اینترنشنال		
شکایت از جمهوری اسلامی در دیوان بینالمللی دادگستری این شکایت	شکایت از جمهوری اسلامی در دیوان بینالمللی دادگستری این شکایت براساس معاهده ۱۹۷۱ مونترال تنظیم شده است جزئیات بیشتر در گفتوگو با اردشیر زارعزاده، مدیر مرکز بین المللی حقوق بشر		
آیا تلاشهای دیپلماتیک جمهوری اسلامی میتواند میزان واکنش اسر	ل را کاهش دهدگفتوگو با شایان سمیعی، کارشناس امنیت ملی و کامران مت ین، استاد روابط بینالملل		
گروه هماهنگی و پاسخگویی برای سرنگونی پرواز پیاس ۷۵۲، شکایت خو	گرو   پا ویی ورای ی یووی پا ۷۵۲، شکای خود از جمهوری الامی را یواوا د داگ اراه ک  اش  مرضوی، ایرا ایتوو و گوگوی  بامد اولیووو ،و هیئ میره الج پواهی اوک		
مارکوس پوتسل، سفیر آلمان در تهران که پس از حدود ۲۰ سال دوباره	مارکوس پوتسل، سفیر آلمان در تهران که پس از حدود ۲۰ سال دوباره به ایر ان بازگشته است، ویدیویی در صفحه اینستاگرام سفارتخانه منتشر کرده که نشان میدهد او به کبابفروشیای که سالها پیش از آن خرید میکرده، رفته و با دادن هدیهای از طرف سفارت آلمان به این کبابفروشی و خرید دوباره ساندویچ کباب از آن، میگوید از نظر م ن این بهترین کباب سطح تهران است		
تلاشهای دیپلماتیک جگفتوگو با سمیرا قرایی، ایر	های را قرایی، ایراناینترنشنال		
ملیحه کیانفر، رییس اداره سلامت میانسالان و مادران وزارت بهداشت	ملیحه کیانفر، رییس اداره سلامت میانسالان و مادران وزارت بهداشت گفت پیمایشی در سال ۱۴۰۰ حدود ۳۱ درصد زنان ایرانی چاق هستند و فقط ۲۸ د رصد آنان وزن متناسب و مابقی اضافه وزن نیز دارنداو افزود یعنی درم وع ۷۲ درصد زنان		
هوری اسلامی به لب	ی اسلامی به لبنان را منتشر کردهاندبر اساس اعلام هلال احمر جمهوری ا سلامی، ۳۵ کامیون مملو از محمولههای امدادی، شامل ۱۹ نوع دارو به لبن ان ارسال میشود		
دو سال پس از اعزام دستهجمعی مدیران سازمانهای دولتی و حکو	ایران اینترنشنال ورزشیدو سال پس از اعزام دستهجمعی مدیران سازمانهای دولتی و حکومتی از ایران به قطر برای مدیریت جو تماشاگران بازیهای تیم ملی در جام جهانی ۲۰۲۲، ذبیحالله خدائیان، رئیس سازمان بازرسی کل کشور خبر داده به دلیل پرداخت غیرقانونی هزینه سفر  و همچنین گفته که پاداشهایی که اعضای هیئترئیسۀ فوتبال بابت جامج هانی قطر گرفته بودند برگردانده شد قرار نیست هر مدیری که به مسابقات ج		
علی دایی، اسطوره فوتبال ایران، در واکنش به عبور لیونل مسی	ت و خیلی از این اتفاق خوشحالم رالدو   مولی ولی  ودود و ۲۰ ۲۰ خیاخیر وی ۱۳ ۱۳وپ طلا گ ک مقط  کو ک   یا ودد  ب تاکی و که بیش از ۱۰۰ گل ملی بهثمر رسانده است، به تابناک گفت این موضوع باع		
۲۴ با فرداد فرحزاد	۲۴ با فرداد فرحزاد		
اسیتهای سیاسی ا	شبکه سیانان به نقل از منابعی با اشاره به اطلاع نتانیاهو از حساسی تهای سیاسی آمریکا نوشت مقامهای احتمال میدهند اسرائیل ایالات متحده به حمله موشکی جمهو ری اسلامی پاسخ دهد، اما زمانبندی و پارامترهای حمله در دولت اسرائیل مورد بحث است		
فهیمه خضرحیدری، روزنامهنگار حتی اگر بپذیریم که ردپای حکومت پ	فهیمه خضرحیدری، روزنامهنگار حتی اگر بپذیریم که ردپای حکومت پشت ا ین ماجراها نیست و حکومت نقشی در این مسمومیتهای الکلی ندارد    ت این ماجراها است		
ی جمهوری اسلا	آاللا ور وزی وزی آلما ، درخوا   ی    سولگ ج   در فو ک گک ک اقام تری لط ب  جمهو الامی ا  و توج آزار  ایرال خواهد ش		
چشمانداز ۲۵ مهر  ۱۴۰۳  ۱۶ اکتبر	چشمانداز ۲۵ مهر  ۱۴۰۳  ۱۶ اکتبرنسخه صوتی برنامه چشمانداز کشت		
محمدجواد اکبرین، روزنامهنگار و دینپژوه اگر حکومت دینی قدرت	محمدجواد اکبرین، روزنامهنگار و دینپژوه اگر حکومت دینی قدرت را به دست بگیرد، در مرحله اول شریعت را به نرمی و در مرحله دوم با خشونت به مردم تحمیل میکند		
یک روند میان ما و آمر یکاییها وجود	وا  خارج جمهوری الامی گ گ یک رو میال  آمریکاییود و  د که             و آ ر ف  متوق ال اما ر تول پیام و القال یاه ط خخخخ ه		
مازیار اشرفیان بناب، متخصص ژنتیک و فوق تخصص پزشکی قانونی افرا	افراد پزشکی قانونی گرس تند		
کشتار مردم پشت نقاب مسمومیتهای الکلی چشمانداز با مهدی مهدوی	کشتار مردم پشت نقاب مسمومیتهای الکلیچشمانداز با مهدی مهدویآ زاد		
محمد مهدی طهرانچی، رییس دانشگاه آزاد گفت صنعت تولید و بهره ب	محمد مهدی طهرانچی، رییس دانشگاه آزاد گفت صنعت تولید و بهره برداری از جلبک و فرآوردههای آن صنعتی است که میتواند اشتعال گستردهای برای جوانان و به خصوص دانشجویان فراهم آورداو افزود باید ببینیم جوا نان چگونه میتوانند از فعالیت در حوزه		
جزئیات بیشتر	آغاز رای گیری زودهنگام انتخابات ریاستجمهوری آمریکا در جورجیا		
نسل جدید ماهواره استارلینک چه ویژگیهایی دارد گفتوگو با اردش	نسل جدید ماهواره استارلینک چه ویژگیهایی داردگفتوگو با اردشیر طیبی، روزنامهنگار		
بررسی توان سامانه پدافند هوایی تاد برای رهگیری موشکهای هایپرس	بررسی توان سامانه پدافند هوایی تاد برای رهگیری موشکهای هایپرسونی ک جمهوری اسلامی در گفتوگو با فرزین ندیمی، تحلیلگر ارشد امور دفاعی و امنیتی در موسسه واشینگتن		
با بالا گرفتن انتقادها از وضعیت انسانی در نوار غزه، شورای امنی	با بالا گرفتن انتقادها از وضعیت انسانی در نوار غزه، شورای امنیت ساز مان ملل متحد جلسه ویژهای برای بررسی اوضاع این باریکه برگزار کردگف توگو با مریم رحمتی، ایران اینترنشنال		
آخرینها از پاسخ اسرائیل به حمله موشکی جمهوری اسلامی جزئیات ب	آخرینها از پاسخ اسرائیل به حمله موشکی جمهوری اسلامی جزئیات بیشتر در گزارش بابک اسحاقی و سمیرا قرایی، خبرنگاران ایران ا		
پولیتیکو لندن از اعلام سپاه پاسداران بهعنوان گروه تروریستی خ	پولیتیکو لندن از اعلام سپاه پاسداران بهعنوان گروه تروریستی خودد اری میکندگفتوگو با بردیا افشین، ایراناینترنشنال		
اجمد جنتیر شورای نگهبان گفت تمامی ملتها و دولتهای مسلما ن	اجمد جنتی، دبیر شورای نگهبان گفت تمامی ملتها و دولتهای مسلمان د ر این شرایط سخت در کنار مردم لبنان و فلسطین باشنداو افزود اسرائیل ن میتواند با ترور رهبران و فرماندهان جبهه مقاومت، راه و رسم مبارزه ب ا ظلم را از بین		
با بالاگرفتن تنشها میان ایران و اسرائیل و نگرانی از وقوع یک ج	اگرف ت  میال ا و و  و  از وق ج جگ تم وم ورخی  ،   ال ا  ا   وول الائیرائیل و ایرال  می ب  باهیو م ، کارش وواال و تلی مطال		
تیتراول با نیوشا صارمی، چهارشنبه ۲۵ مهر	تیتراول با نیوشا صارمی، چهارشنبه ۲۵ مهر		
گلرخ ایرایی، زندانی سیاسی در زندان اوین، درباره احتمال اجرای ح	گلرخ ای  زدالی  د ز ال اوی  ، احمال اج وشیاله ا  ، ن ، ن  قط دورا اک ک مرگ باد  هم یا ود واکش د ،		
زن، در بیانیها	، در بیانیهای از این اتفاق عذرخواهی کرد امشب در برنامه با کامبیز حسینی از شما میپرسیم نظر شما دربارهی ا ین اقدام صداوسیما چیست اگر برای این سوال پاسخی دارید به واتساپ و تلگرام ما پیام بفرستید ت ا لینک شرکت در برنامه امشب برایتان ارسال شود تلفن برنامه ۰۰۴۴۷۵۱۰۱۱۰۱۱۰		
طنین تاریخ  قسمت پنجاه و نهم	طنین تاریخ  قسمت پنجاه و نهمطنین تاریخ قسمت پنجاه و نهمبازرگان و شروع اختلافاتش با سپاه پاسداران وکمیته هاتهیه کننده و مجری عبداله عبدی		
پیکر عباس نیلفروشان، فرمانده نیروی قدس در لبنان، چهارشنبه ۲ ۵	پیکر عباس نیلفروشان، فرمانده نیروی قدس در لبنان، روز چهارشنبه ۲۵ م برای		
احسان شریفی دبیر انجمن سکته مغزی ایران گفت شیوع و بروز سکت ه	غزی در ایران حدود ۱۵ برابر متوسط جهانی استاو افزود همچنین سکته مغزی در ایران از متوسط جهانی حدود ۱۰ سال جوانتر است		
محمود فکری، سرمربی مس شهر بابک، در روز اعلام حکم محرومیت چ	ایرال ایشورزشی کک ش  ب ک، کوز کم  ک  ف ز زوت ، از ک یکو ی ی ی ی ی ی ی ی ی ی ی ی  م ک دای کای و ایچ  الی علی  س ، س  کووی   کرا و وو پیشیولالالا    گرفتفکری با حکم کمیته انضباطی فدراسیون فوتبال در پی صحبتهای مراهی تیمش محروم شد		
در حالی که مسوولان نظام آسیب دیدن چشم سفیر جمهوری اسلامی در لب	دالی که م آ آ ی چش  ج جمهوری الامی لور کذی کذی کذی ، ت ای ایول  درزاد تو شی از مجتبا پورمحسن		
در پی انتشار اخباری مبنی بر کشته شدن اتباع افغانستانی در مرز س	در پی انتشار اخباری مبنی بر کشته شدن اتباع افغانستانی در مرز سراوان ، نماینده ویژه رییس جمهور در امور افغانستان این موضوع را تکذیب کردگف توگو با مهدی نخلاحمدی، روزنامهنگار و فعال سیاسی		
پیمان جبلی، رییس سازمان صداوسیما گفت برخی چهرهها و رسانهها	پیما جی، ریی صااو  گ خی چهره و و و  از ایک  و    ۷۰ ۷۰ ا ملی ج  ، اما مورد تخریب قرار میگیریم		
سیانان حمله احتمالی اسرائيل به جمهوری اسلامی پیش از انتخابا	حمل  احمالی الائيل ب جمهو پیش از الخا آ خواد دوگوگوگوگ  ق		
چهار کشور اوکراین، کانادا، انگلیس و سوئد شکایتی را در خروند ه	چهار کشور اوکراین، کانادا، انگلیس و سوئد شکایتی را در خصوص پرونده س		
گروه بینالمللی هماهنگی و پاسخگویی در مورد ارائه دادخواست پروا	گروه بینالمللی هماهنگی و پاسخگویی در مورد ارائه دادخواست پرواز ا وکراینی در بیانیهای اعلام کرد که بریتانیا، کانادا، سوئد و اوکراین اراستی اند و مرحله بعدی دادرسیها علیه ایران را در رابطه با نقضهای آنک نوانسیون ۱۹۷۱ برای  اقامات غیووو ایملی ا هظ آغاز کردها ای آاومده  ام امات ولی جلوگی د الهدام پ د اوک ت تو  ی کاملا شاف و و مطابق با استانداردهای بینالمللی پیش ببرد    یی برای قربانیان و خانوادههایشان برجسته میکند		
حائری، زندانی	شعبه اول بازپرسی ناحیه یک دادسرای کرج در پروندهای جدید احمدرضا حا ئری، زندانی سیاسی محبوس در زندان قزلحصار را به دلیل فعالیتش در کارزا ر سهشنبههای نه به اعدام، به تبلیغ علیه نظام و نشر اکاذیب متهم ڱ دهمچنین مقامات قضایی با		
عقاب پشت یک دلاری آمریکا از کجا آمده آمریکا۲۰۲۴	عقاب پشت یک دلاری آمریکا از کجا آمده آمریکا۲۰۲۴		
ی، ایراناینترن	یراناینترنشنال		
ارد شمال غزه نش	شمال غزه نشده است مریم رحمتی، ایران اینترنشنال از جلسه اضطراری شورای امنیت درباره غز ه میگوید		
به ساعت ۱۹۳۰ به	ایاست جمهوری امریکا دونالد ترامپ و ایران دوشنبه ساعت ۱۹۳۰ به وقت تهران		
مجتبی فاضل، مدیر حوزههای علمیه زنان گفت چه کسی فکر میکرد ا	امروزه تمام دنیا به قدرت موشکی و تسلیحاتی ما غبطه بخورند و خواهان خریداری ا ین تسلیحات باشنداو افزود این نشان میدهد که ما توانستهایم خودما ن را در معادلات جهانی نشان دهیم		
ویدیوی منتشرشده در رسانههای اجتماعی نشان میدهد یک پاراگلاید	ویدیوی منتشرشده در رسانههای اجتماعی نشان میدهد یک پاراگلایدرسو ار هنگام پرواز بر فراز اهرام ثلاثه مصر، از حضور یک قلاده سگ روی یکی ا ز هرمها تصویربرداری کرده است		
خانه آزادی، سازمان آمریکایی حامی دموکراسی، در گزارش جدیدش در	خانه آزادی، سازمان آمریکایی حامی دموکراسی، در گزارش جدیدش درباره آزادی اینترنت در جهان نوشت ایران بعد از چین و میانمار در قعر جدول آز ادی اینترنت است طبق این گزارش، چین و میانمار در رتبه آخرند و ایران و روسیه به ترتیب بعد از آنها در انتهای این رتبهبندی قرار دارند		
اعلام سپاه پاسدا	لام سپاه پاسداران بهعنوان یک گروه تروریستی، از این اقدام خودداری ند منابع دولتی به پولیتیکو گفتهاند ایوت کوپر، وزیر کشور بریتانیا، ت مایلی به قرار دادن نام سپاه پاسداران در فهرست گروههای تروریستی ندا رد		
نخستین نشست مشترک کشورهای اتحادیه اروپا و شورای همکاری خلیج فا	خ   مش  کشای اتایه اوپا ورای ه خلیج فار ، دوز مکاری خلیج فاورگزار میشود ت یشر ومص پا ، ایرال ایش		
انتخابات آمریکا ۲۰۲۴	انتخابات آمریکا ۲۰۲۴		
نمایشگاه بینالمللی کتاب فرانکفورت از امروز در این شهر آغاز به	کااب کرد هر ساله در این نمایشگاه، یک کشور بعنوان مهمان ویژه شرکت میکند و می لیا استاحمد صمدی و کیمیا قربانی، خبرنگاران ایران اینترنشنال گزارش م ی دهند		
فاطمه مهاجرانی، سخنگوی دولت میگوید بعلت تحریم هواپیمایی کشو	فاطمه اجرالی،  دوی دولت میگوی  تریم هواپی کشوری، دولت مج لغو پرواز  ز تاثیر ای تری		
سخنگوی دولت پزشکیان امروز در حاشیه جلسه هیات دولت، با تاکید بر	بات قانونی پرستاران و بازنشستگان و گندمکاران از دولت، گفت دولت خا طر محدودیت بودجه توان پرداخت مطالبات آنها را نداردگفتوگو با رضا بی، روزنامهنگار اقتصادی		
گفت امروز زن	گف ت امروز زنان، محکم و استوار، در کنار مردان و زنان دیگر به زیارت میر وند و بازمیگردند و زینبوار میکننداو افزود امروز لازم مادران برای جریان مقاومت، سرباز تربیت کنند		
براساس گزارشهای رسیده به ایران اینترنشنال، فشارهای امنیتی بر	ماگران مستقل در روزهای اخیر افزایش یافته است و کیک محبوب من احضار و گ		
سه زندانی سیاسی محکوم به اعدام برای اجرای حکم، به انفرادی، زند	یدار اهواز منتقل شدند ا  ای ، ش مشارک قر ق دو یک پ   وی الظ و یک یک و ز وگوگوگوگو  وجا تليلگ ول ال وه و		
ام زیستی و امدا	زیستی و امدادی برای مردم جنگزده لبنان به سوریه ارسال شدهمچنین احس ان نصیری، عضو هیات مدیره شرکت داروسازی سها از آمادهسازی و ارسال ۳۵    کشور لبنان خبر داد		
محمد قنبری، رییس پلیس آگاهی کشور گفت از ابتدای سال ۱۱ هزار پ	محمد قنبری، رییس پلیس آگاهی کشور گفت از ابتدای سال ۱۱ هزار پیامک به گفتیم که میدانیم کجایید و چه میکنی  لان ماهیت کیفقاپی به موبایلقاپی تغییر یافته است		
در حالی که سامانه نقلوانتقالات فیفا از بستهبودن پنجره نق	ایرال ایتش ورزشی کاما والق ا از ت  اه پ  ی ش ای  ، شوول و پجوه ، ،ر اطه ا الام کرده وه وه ب پ یهای خارجی از ط  در این اطلاعه آمده باشگاه پرسپولیس با ارسال نامههای رسمی به فی فا درخواست کرد تا از پولهای باشگاه در فیفا بدهی به پریرا، دیاباته و باهویی پرداخت شود با رسمی شدن حکم بدهی باشگاه پرسپولیس از سوی فیفا، باشگاه پرسپولیس ن یز برای جلوگیری از خروج ارز از کشور با ارسال نامههای رسمی به فیفا د پریرا، رداخت شوداز این رو با توجه به نامهنگاریهای انجام شده از سوی باشگاه پرسپولیس به فیف ا، بدهی این سه بازیکن خارجی پرداخت خواهد شد این روال در جریان پروندههای قبلی باشگاه نیز طی شد و به انجام رسیده بود در فیفاست		
جمعی از معلولان روز چهارشنبه ۲۵ مهرماه برای پیگیری مطالبات معی	ج از م ز چهارش ۲۵ م م پیگی ط مطال   خود ، مق    ریا یی از جمله  ، ، ای کایی		
اخیر گفت مقدا	یر گفت مقداری از این اتفاق به شرایط منطقه و وضعیت سایبری موجود برمی  افزود دنبال میشود		
طبق گزارشهای رسیده به ایراناینترنشنال، در حالی که اخیرا از ت	تعدا  ازیگران و عوامل فیلمها احضار و با فی لم دانه انجیر معابد نامزد جایزه آسیا پاسیفیک شد مراسم اهدای این جایزه ۳۰ نوامبر برگزار خواهد شد    لهای از ابهام قرار دارد		
بررسی چهارشنبه، ۲۵ مهر			
نشست سالانه شورای کشورهای عضو سازمان همکاری شانگهای امروز دراس	نشست سالانه شورای کشورهای عضو سازمان همکاری شانگهای امروز در اسلام آباد، پایتخت پاکستان برگزار می شود تمرکز این نشست بر گسترش روابط اقتصادی میان اعضای این سازمان استگفت وگو با جواد همدانی، ایران اینترنشنال		
حیف قد بلندت ما	قد بلندت مادر که بخواهی خم شوی		
درپی ادامه حملات هوایی اسرائیل به لبنان، ساختمان شهرداری نبطیه	قرار گرفت شهردار این شهر از جمله کشته شدگان این حمله گزارش شده است ارتش اسرائیل گفت، مواضعی از حزبالله را هدف قرار داده استگفتوگو با مهرداد فرهمند، تحلیلگر مسائل خاورمیانه		
تلاشها در عراق برای ایجاد گفتوگوی مستقیم بین تهران و واشینگت	تلاشها در عراق برای ایجاد گفتوگوی مستقیم بین تهران و واشینگتن ن		
حسین راغفر، اقتصاددان و استاد دانشگاه، گفت سرانه گوشت در جه ان	حسین راغفر، اقتصاددان و استاد دانشگاه، گفت سرانه مصرف گوشت در جهان ۳۰ کیلوگرم و در ایران پنج کیلوگرم است او افزود ۵۰ درصد از کودکان در سیستان و بلوچستان دچار کوتاهقامتی ن اشی از سوءتغذیه هستند		
به هدف اصلی حملا	شرکت مایکروسافت اعلام کرد اسرائیل از آغاز جنگ غزه در سال گذشته، به ده است احمد صمدی، ایران اینترنشنال گزارش میدهد		
نیمرخ  یک سال پس از مرگ محمد الفاید، میلیاردر مشهور مصری و م	نیمرخ  یک سال پس از مرگ محمد الفاید، میلیاردر مشهور مصری و مالک سا بق فروشگاه مشهور هرودز، حدود ۶۰ زن او را به تعرض جنسی در یک بازه زمان ی ۲۵ ساله متهمکردهاند		
دادبان  صدور قرار بازداشت برای چه اتهاماتی غیر قانونیست	دادبان  صدور قرار بازداشت برای چه اتهاماتی غیر قانونیست		
گفت به علت تحر	ایرانایر گف ت به علت تحریمها هواپیمایی کشوری مجبور به لغو پروازها شد وقتی هواپیمایی تحریم میشود به پروازها اجازه نشستن نمیدهند و د ر صورت نشستن هواپیما توقیف میشود لغو دولت بود		
سیما پس از پخش موسیقی با صدای سارنگ صیفیزاده، خواننده زن، برا	ای عدم رعایت حدود شرعی عذرخواهی کرد روابط عمومی صدا و سیما اعلام کرد، مسئولان با برخورد جدی با عامل این زنان و تحلیلگر مسائل اجتماعی		
گزارش محمد سیانکی در جریان پخش زنده بازی ایرانقطر از شبکه	ایرال ایتورزشیگزال وورزشیگز  یا جریاو پخش پخش ز ای ز ش  صا و ومای ی ی، الامکشووو ی مخخلی همراه شه ا نامناسب و بی ارتباط با روند بازی، آزاردهنده بوده است    د تمسخر قرار داده استدر پربازخوردترین کریم انصاریفرد، پیشین تیم ملی فوتبال ایران، با انتشار یک استوری نوشت با این ه استعداد گزارشگری که داریم، چگونه به افوراد اجازه گزارش وملی داده میشود  و   مد طاو  ز را د  ، ت تایای آ  یوپد قلویی،ویی،  ی ی  فوت    ا اد از از از از از گفت که از جبلی تعجب میکند که به افرادی که و بغض دارند، تریبون میدهدشما به گزارش محمد سیانکی در بازی ایرا نقطر از یک تا ۱۰ چه نمرهای میدهیدشما میتوانید در اینستاگرام ایران اینترنشنال ورزشی در اینباره اظهارنظر کنید		
ارتش اسرائیل گوید، دهها نیروی نظامی حزبالله را در نبطیه ل بن	ان کشته استبابک اسحاقی، ایران اینترنشنال گزارش میدهد		
با اعلام رسمی اتحادیه فوتبال انگلستان، توماس توخل، سرمربی	فوتبال انگلستان انتخاب شد		
دادستان نیس از دادگاه برای وسام بنیدر، کاپیتان پیشین مونا	، کاپیتان پیشین موناکو و بازیکن سابق تیم ملی فوتبال فرانسه، به اتهام تجاوز جنسی به یک زن ۲۳ ساله در حالت مستی تحت تاثیر استفاده از مشروبات الکلی، دو سال و نیم حبس درخواست کردبنیدر که از زمان تفهیم اتهام بابت تجاوز جنسی به یک زن در نیم الک گفته که به دلیل مصرف الکل چیزی را به اد نمیآورد و تنها چیزی ک  ذ  ، ص مصرف و از ی وی  کولا دود ۲۰۸ود خگ  ا ب پیشی خرو ب  پیشی خود  متهم شه و و و  از وجود چ جاوز یگ از ول و سه سال گذشته خبر داده، از سوی دادگاه با محدودیتهای مختلفی از جمله خروج از خانه در بین ساعات هشت شب تا شش صبح، ممنوعیت حضور در مامی کلابهای شبانه و الزام به دو بار معرفی در هفته به پلیس برای ترک اعتیاد به الکل تا زمان صدور رای، مواجه شده است		
کمیته انضباطی فدراسیون فوتبال رای خود را در خصوص اظهارات م	ر عذرخواهی او، سرمربی مس شهر بابک را ۴ ماه محر وه پ جلیوول توماو جومکوم ک طی و همچ  دورال مصاحوه مصو  رئی محرز ال   کود کری،  و مربی کنونی مس شهربابک، در اظهاراتی همجنسگرا ستیزانه در پاسخ به سوال یک خبرنگار درباره نیمکت استقلال گفته بود مدیران استقلال همه زشی هستند خواهش میکنم دنبال سرمربی همجنسگرایی که متاسفانه مفعول هم هستند، نروندجزئیات بیشتر را اینجا بخوانید		
نیلفروشان، معاو	لفروشان، معاون عملیات سپاه که در لبنان کشته شد، نماز خواندپیشتر ف  برای نیلفروشان، مانند بسیاری از فرماندهان کشته شده سپاه نماز میت خواهد خواند		
گفتوگوی ویژه مصطفی علوش، نماینده پیشین پارلمان لبنان یکشنبه	گفتوگوی ویژه مصطفی علوش، نماینده پیشین پارلمان لبنانیکشنبه، ۱ ۹۳۰ به وقت تهران		
شاتر  مروری بر آثار هنر اعتراض	شاتر  مروری بر آثار هنر اعتراض		
آتلانتیک، در گزارشی با عنوان دکترین شکستخورده علی خامنهای	آتلانتیک، در گزارشی با عنوان دکترین شکستخورده علی خامنهای به م اسلامی پرداخته استاردوان روزبه ، ایران اینترنشنال گزارش میدهد		
واست، سپاه پاس	رهبر ائتلاف مخالفان دولت این کشور خوا ست، سپاه پاسداران را در فهرست گروههای تروریستی قرار دهدعلیرضب محب ی، ایران اینترنشنال گزارش میدهد		
صوص لایک کردن م	خ گزاری ، وات  پا  ، ، فوای خای خوص خصوص کوومطال   ضای  ک تخام ی گه لایک یایی   ضاولا و و ش صوری ک   اشاو  ، ،وی ج تضعیف نظام بشود، جایز نیست		
پلیس اسرائیل از دستگیری یک شهروند اسرائیلی به اتهام رابطه با م	پلی از د یک یک شهرو الائیولی و اته وه  ما جمهو خور خا داد ا ال ای		
سرخط خبرهای چهارشنبه، ۲۵ مهر	سرخط خبرهای چهارشنبه، ۲۵ مهر		
حسین شریعتمداری، نماینده خامنهای در روزنامه کیهان، با اشاره ب	ح شریمداری،  خام  کیه کی ب ب ا اشا  شرک هک واپیمایی ای ، م ما ا ا ز  از از از از  ه ا ، ،  ش ت   و وه وه و ح کش کش کش کش کش حا کاری و تی کشورهای  در یا کشور کشا کشو  عضو اتحادیه اروپا ببندیم		
از خاکستر ژاپن، بخش سوم سهشنبه، ۱۹۳۰ به وقت تهران	از خاکستر ژاپن، بخش سومسهشنبه، ۱۹۳۰ به وقت تهران		
مارسلو، کاپیتان و ستاره پیشین رئال مادرید، در صفحه اینستاگ	ید، در صفحه اینستاگرام خود ویدیویی منتشر کرده که در آن پسر این ستاره		
آرژانتین در هفته دهم رقابتهای انتخابی جام جهانی در آمریک	جاک داد فوقستاره آرژانتینی فوتبال علاوه بر ثبت دهمین هتتریک در وره کرد		
مدیر مسئول کیهان، خواستار بستن تنگه هرمز بر روی کشتیهای اتحاد	اتحادیه رکنش های اتحادیه اروپا را بررسی میکند		
گفت اعتقاد ما	احمد آریاییژاد ، یلای جر   س ی  وورا گ   ای ال ک ی ی پی  پیوزیوو شمشی ک کی  ازود د ی در خود آمریکا ، ی  ال جهالی د باهرات  و صاوی خا		
مئیر جاودانفر، تحلیلگر مسائل اسرائیل یکی از عواملی که باعث تغ	مئیر جاودانفر، تحلیلگر مسائل اسرائیل یکی از عواملی که باعث تغییر د ر تعیین اهداف حمله احتمالی اسرائیل به جمهوری اسلامی میشود، فشارها ی ایالات متحده است		
گزارش خود، ساختار انتخاباتی آمریکا را تشری	گزارش خود، ساختار انتخاباتی آ مریکا را تشریح میکند		
این کشور به آل	دولت ایتالیا، قراردادی تازه برای انتقال پناهجویان غیرقانونی از ای هد		
مایکروسافت اعلام کرد، اسرائیل از آغاز جنگ غزه، به هدف اصلات سا	یبری و کمپینهای مجازی جمهوری اسلامی تبدیل شده استبررسی بیشتر در گفتوگو با مهدی صارمیفر، روزنامهنگار علم و تکنولوژی		
در پی افزایش آمار کشتهشدگان مشروبات تقلبی در چهار استان ایران	در پی افزایش آمار کشتهشدگان مشروبات تقلبی در چهار استان ایران، رو کردگفت وگو با رقیه رضایی، روزنامهنگار و عضو تحریریه ایرانوایر		
گفت، کشورش خواستار آتشبس فوری در غزه، حفاظت از غیرنظ	امور خارجه استرالیا گفت، کشورش خواستار آتشبس فوری در غزه، حف    ا محبی، ایران اینترنشنال		
وزیر امور خارجه چبن از جمهوری اسلامی و اسرائیل خواست، به چرخه	خارجه چ ز جمهوری الامی و اس خوا ، چوه چ خش ویرالگ خاتمه د  طو ایرال وول  ش میهد		
علیرضا جهانبخش مدعی شد پس از گرفتن میزبانی از ایران، بازیک	ایرال ایشورزشی وورزشی جهخش خش ش پ پ پ پ پ ز گ میز ای ، بازیک یم م ایو دها وق ای شاو را داش ما زی قطر خاو کو ، پ از مشورت ورت   سوو  ،  یزززززززززززززززززززززززززززززززززززززززززززززززززززززززززززززززززززززززززززززز  سایر بچههایی که اینجا بازی کردند به این نتیجه رسیدیم که دوبی می تواند گزینه خیلی خوبی باشدآنطور که فارس گزارش داده کاپیتان تیم ملی که پس از بازی با قطر با خبرنگاران گفتگو میکرد، در ادامه گفت امروز استادیوم راشد مثل خانه ما بود از همه ایرانیهایی که آمدند و حمایت کردند و همچنین باشگاه شباب الا هلی تشکر میکنیم امکانات مناسبی در اختیار ما گذاشتند		
تیم ملی فوتبال اسپانیا، قهرمان یورو، در چهارمین مسابقه خود	ایرال   یج  ور ص صر صر بوه پیروزی و و وه امیاز پیول گول گول گول خود جای گلزنی کردنددر دیگر بازیهای امشب، سوئیس و دانمارک به تساوی دو بر دو رسیدندکرواسی و لهستان هم د ر مسابقهای پرگل به تساوی ۳۳ دست یافتندپرتغال و اسکاتلند هم به ب دونگل مساوی کردند		
شنبه ۲۲ مهر در من	حالوش سهشنبه ۲۴ مهر گزارش داد ماموران مرزی جمهوری اسلامی یکشن به ۲۲ مهر در منطقه کلگان سراوان به مهاجران افغانستانی که قصد ورود به نقل    مهالال اغال حود ن وک که از ای تاد قط  ۷۰ ۷۰ور ز م او  افراد یا کش  یا بت    فری حمی د داد کل پیشی اغال ، د		
صدا و سیما در اطلاعیهای پخش صدای یک خواننده زن در یک برنامه ت	یک ونی را سهلانگاری و خطای فردی خواند وگفت مقامهای صدا وسیما فورا		
متیو میلر، سخنگوی وزارت خارجه آمریکا، سهشنبه ۲۴ مهر در نشست خ	متیو میلر، سخنگوی وزارت خارجه آمریکا، سهشنبه ۲۴ مهر در نشست خبری خود گفت تهدیدها علیه ترامپ و مقامهای دولت پیشین آمریکا را به عنوان یک مساله امنیت ملی با بیشترین اولویت تلقی میکنیم این تهدیدهای گستاخانه را به شدت محکوم میکنیم و به وضوح مشخص کرده  مدهای آن را خواهد دید		
مراد ویسی، ایران اینترنشنال همزمان با شرایط موجود و افزایش ان	مراد وی ای ایت ز ش تایج ای  ال ی ماج یه میشود		
مراد ویسی، ایران اینترنشنال همزمان با افزایش انتظارات برای در	مراد وی ای ایتوولشو  زما ازایش الظارات بر د ووم ی ، ز فرما وهقه وه و و  و و و و ظ وه   رئی  ح   مو دا ری فر و مرد		
مراد ویسی، ایران اینترنشنال یکی از مسائل جدی فرماندهان اسرائی	مراد وی ای ایتشولال از  ج فر ا الائیل وضوضوضوضوض دو هام ج گ ا  ج ، ، ی  امی ق خ خز آماد مرد ی درگی حمی، قط قط وی جولگ احمالی ا  ل  تقریبا در کشور پناهگاهی برای مردم ساخته نشده است		
سیاست با مراد ویسی  ۲۴ مهر  ۱۴۰۳  ۱۵ اکتبر	ومراد وی   ۱۴۰۳ ۱۴۰۳ ۱۵ ک اکلل صوی ی وروه       وی آ جگی الائیل وریالامی حمل ز یک ا		
جو بایدن سهشنبه ۲۴ مهر در نامهای به روسای مجلس نمایندگان آمر	جگ و سنا و رهبران احزاب دموکرات و جمهوریخواه در دو مجلس، با تشریح اقدا مهای واشینگتن در دفاع از اسرائیل در برابر حملهها و تهدیدهای جمهو ری اسلامی و نیروهای نیابتی آن، از جمله استقرار سامانه موشکی تاد    ها در این زمینه تاکید کرد		
امشب در برنامه با کامبیز حسینی کشتهشدن نیلفروشان و رونمایی	امشب در برنامه با کامبیز حسینی کشتهشدن نیلفروشان و رونمایی از اس ماعیل قاآنی را بررسی کردیم قاآنی کجا بود نه واقعا این کجا بود دو هفته بود غیب شده بود، کجا بود اگر بود چرا برای نشوندادنش موش و گربه بازی درآوردند کجا قایمش کرده بودندبرای دیدن نسخهی کل برنامه به یوتیوب ایران ای نترنشنال سر بزنید		
ویدیوهای منتشر شده حاکی است که گروههای نشانی در تلاشند آ تش	ویدیوهای منتشر شده حاکی است که گروههای آتشنشانی در تلاشند آتش سوزی گسترده در پالایشگاه شوشتر را مهار کنند مخازن بنزین بوده است		
پالایشگاه شوشتر در شامگاه سهشنبه، ۲۴ مهر، دچار آتشسوزی وسیعی	و کشته جای گذاشته است ازن بنزین بوده است		
را اعلام نکرد،	روزنامه نیویورکتایمز به نقل از دو مقام اسرائیلی مطلع که نامشان را اعلام نکرد، گزارش داد حتی اگر اسرائیل از حمله به سایتهای غنیساز ی هستهای و نفت ایران خودداری کند، همچنان میتواند طیف گستردهای		
ه دادگاه خبر	دادستان تهران از صدور کیفرخواست پرونده فساد چای دبش و ارسال آن به د ادگاه خبر داد و گفت این کیفرخواست ۳۵۰ جلد و ۷۰ هزار صفحه دارد او افزود بیش از ۳۰ هزار میلیارد تومان تسهیلات بانکی بدون ضوابط ومق ررات در اختیار این گروه گذاشته شد که ۹ هزار میلیارد تومان آن معوق شده است		
نخستوزیر هند، جاستین ت	تلاشها برای آرام کردن تنش بین هند و کانادا ادامه دارد نخستوزیر هند، جاستین ترودو را به منفعت طلبی سیاسی در حمایت از سیک های جداییطلب متهمکرده کدا همچو د		
یوآو گالانت، وزیر دفاع اسرائیل، در دیدار با شماری از خانوادهه	یوآو گالانت، وزیر دفاع اسرائیل، در دیدار با شماری از خانوادههای		
انتقادها از اسرائیل به دلیل حمله به نیروهای حافظ صلح جزئیات ب	انتقادها از اسرائیل به دلیل حمله به نیروهای حافظ صلح جزئیات بیشتر در گزارش نیلوفر پورابراهیم، ایران اینترشنال		
تجمع و اعتراض و	نفتاز ع و اعتراض و بازگشت به کار کارگران اخراجی استبررسی بیشتر این موضوع ر گفتوگو با فواد کیخسروی، فعال کارگری		
برنامه با کامبیز حسینی  ۲۴ مهر  ۱۴۰۳  ۱۵ اکتبر	کامبیز حسینی  ۲۴ مهر  ۱۴۰۳  ۱۵ اکتبر نسخه صوتی برنامه		
فرماندار شوشتر اعلام کرد یکی از مخازن سوخت در پالایشگاه پتروشو	فرماندار شوشتر اعلام کرد یکی از مخازن سوخت در پالایشگاه پتروشوشتر در استان خوزستان دچار آتش رسانهها با انتشار تصاویری از این آتشسوزی، گزارشهای از		
جمهوری اسلامی گف	نخعیراد، نماینده مشهد با تاکید بر تغییر دکترین اتمی جمه وری اسلامی گفت شرایط امروز کشور متفاوت شده و مورد تهدید هستهای قرا ر گرفتیم ق		
امیر قلعهنویی، سرمربی تیم ملی فوتبال، در پاسخ به انتقادی	در پاسخ به انتقادی درباره میانگین سنی بالای تیم ملی گفت ما یواش یوا ش باید تغییر داشته باشیم ولی تغییری که منتج به نتیجه بشود    کنایه به شعار هواداران علیه خودش در ورزشگاه فولادشهر، پس برتری براب ر قطر گفت از تمام بازیکنان و مجموعه تیم تشکر میکنم دقایقی که عقب بودیم، تماشاگران واقعی در ورزشگاه بودند و تیم را تشوی ق کردند و باعث شدند بازی را برگردانیمسرمربی ایران در اشاره به ت منتقدان تیمش در تلویزیون، با انتقاد از رئیس صداوسیمای جمهوری اسلا می گفت پیشکسوتانی مانند بهتاش فریبا، ح فرکی، مصص، چراغپو از کسانی مثل حسن روشن که از ما انتقاد میکند ولی خیلی وقتها هم راه نمایی میکند خیلیها مثلا در صداوسیما و جاهای دیگر دنبال حب و بغض و تسویه حساب ه ستند که نمیخواهم بحثش را باز کنم هار نظر کنند		
مقامات ارشد آمریکایی به دستور جو بایدن پیامهایی را به بالاتری	مقامات ارشد آمریکایی به دستور جو بایدن پیامهایے وح دولت ایران ارسال کرده و به تهران هشدار دادند که تمام توطئهها علی ه ترامپ و مقامات سابق آمریکا را متوقف کندگفتوگو با آرش آرامش، حقوق دان و کارشناس امنیت ملی		
دقایقی پیش سخنگوی وزارت خارجه آمریکا در پاسخ به سوالی واک نش و	دقایکا در پاسخ به سوالی درباره واکنش		
پنتاگون سامانه تاد در آینده نزدیک، به طور کامل در اسرائیل عمل	پنتاگون سامانه تاد در آینده نزدیک، به طور کامل در اسرائیل عملیاتی خواهد شد بررسی بیشتر این موضوع در گفتوگو با فرزین ندیمی، تحلیلگر امور دفاع ی و امنیتی در موسسه واشینگتن و بن سبطی، پژوهشگر ایران و اسرائیل		
اسماعیل کوثری، نماینده تهران گفت که حسن تهرانی مقدم، رییس سازم	اسماعیل کوثری، نماینده تهران گفت که حسن تهرانی مقدم، رییس سازمان ج هاد خودکفایی سپاه پاسداران و فعال در حوزه ساخت موشککه در سال ۱۳۹۰ با انفجار زاغه مهمات پادگان مدرس به همراه برخی دیگر از اعضای سپاسد اران کشته شد، در حال ساخت و تست موشک قارهپیما بود		
یر خارجه آمریکا	خارجه آمریکا بلینکن و آستین درباره اقدامات اسرائیل ابراز نگرانی کردهاند گفتوگو تحلیلگر سیاسی و شکریا برادوست، پژوهشگر امنیت بینالملل و سیاست خار جی		
رویترز به نقل از اسکای اسپورت نوشت که توماس توخل، سرمربی س	ماس توخل، سرمربی سابق بایرن مونیخ و چلسی، قراردادی برای نشست روی نیم کت تم ملی فوتبال انگلستان امضا کرده است، این مربی آلمانی پس از اسون گ وران اریکسون سوئدی و کاپلو ایتالیایی  م خارجی الجی ا ک دای شیورها  ور میگیرد  تایایی ک ک  الگ اتایای فوتوتوت کشور و معرفی میشود		
دقایقی پیش، سخنگوی پنتاگون، تایید کرد که آمریکا سامانه تاد را	تقویت دفاع هوایی اسرائیل فرستاده تا در صورت واکنش ایران، به سرنگونی موشکهای بالستیک کمک کند		
هاند به چه اه	شبکه خبری کان نیوز اسرائیل گزارش داده مقامات این کشور تصمیم گرفته کنندگفتوگو با سمیرا قرایی، ایران نترنشنال		
مهمان پنجشنبهی ویژه برنامه با کامبیز حسینیاین هفته ۲۶ اه،	مهمان پنجشنبهی ویژه برنامه با کامبیز حسینی، این هفته ۲۶ مهرماه ، نوشابه امیری خواهد بود روزنامهنگار و گویندهی شناخته شدهی ساکن پاریس نگاری کودکان دهههای شصت و هفتاد استبرای شرکت در برنامه و گفت وگو با نوشابه امیری به واتساپ و تلگرام ما پیام بفرستید تا لینکشرکت برایتان ارسال شود تلفن برنامه ۰۰۴۴۷۵۱۰۱۱۰۱۱۰		
شهاب اسفندیاری، رییس دانشگاه صداوسیما رها کردن فضای مجازی را	شهاب اسفندیاری، رییس دانشگاه صداوسیما رها کردن فضای مجازی را غیر ش رعی خواند و گفت هیچ پیامرسانی در غرب اجازه ندارد بدون پاسخگویی قوقی به حکومت فعالیت کنداو افزود در این شرایط برخیها در ایران صور تمسئله را پاک میکنند و میگویند چرا فیلترینگ را برنمیدارید		
۲۴ با فرداد فرحزاد	۲۴ با فرداد فرحزاد		
علم صالح، دانشیار روابط بینالملل دانشکاه ملی استرالیا کشوری	کشوری که		
چشمانداز ۲۴ مهر  ۱۴۰۳  ۱۵ اکتبر	چشمانداز ۲۴ مهر  ۱۴۰۳  ۱۵ اکتبرنسخه صوتی برنامه چشمانداز جمه وری اسلامی و رویای بمب اتمی		
جمهوری الامی و ویای وم  اتمی چشمالداز  ی مهدویآزا			
فرزانه روستایی، روزنامه نگار و تحلیلگر مسائل بینالملل وضعیت	فرزاله رو روزوز  و تلیلگ   المل   ج جمهوری الامی  ا  کوی یک   رورد ال و وه دلیل شکاهری و یزیک یزیک    آ  قاد و   آ آ		
لها و مراتع کش	محلد خ خ  ز گ کشوو را اکو ی وهای وا د ال ال او ازود یا پ یی، وه ظا ن   اما ویرانگر است		
تیم ملی فوتبال ایران در چهارمین بازی خود در انتخابی جام جه	ده بود، با درخشش سردار آزمون و محمد محبی به بازی برگشت و چهار بر یک پیروزی رسید آزمون و محبی هر کدام دو گل در این بازی به ثمر رساندندایران با این گروه  قرار گرفت		
شبکه کان اسرائیل به نقل از یک مقام ارشد این کشور گزارش داد تصم	مقام کدام اهداف در ایران حمله کنند، در سطوح هدفها مشخص هس تند، حالا فقط مساله زمان است		
محققان از شیوه جدید درمانی و کاهش ۴۰ درصدی خطر مرگ در اثر سرطا	ه رحم خبر میدهند وگو ه ایمنیشناسی سرطان کینگزکالج		
دلیل ارسال موشک	ل ارسال موشک به روسیه تحریم کردگفتوگو با مریم دهکردی، روزنامهنگا ر و عضو تحریریه ایران وایر		
سنوار به تقابل مستقیم نظامی بین ایران و اسرائیل امید دارد تا ف	ظامی برغزه کاهش یابد بررسی بیشتر این موضوع در گفتوگو با غسان عاشور، تحلیلگر مسائل خاور میانه		
داده که اگر	ی، فعال و تحلیلگر سیاسی و مرتضی انواری، مقام پیشین وزارت دفاع آمریکا		
تصمیم نهایی کابینه امنیتی اسرائیل براخ به حمله موشکی جمهور ی ا	تصمیم نهایی کابینه امنیتی اسرائیل برای پاسخ به حمله موشکی جمهوری ا سلامی    زین ندیمی، تحلیلگر امور دفاعی و امنیتی در موسسه واشینگتن		
ا اشاره به مطا	مح طاهری آکری، د  امر    و  از ملک  اشال   ورای ر یلت ش ی اج  زما ک   و و و و و  ما د دال د پ ش  هوی خوش  داد وه شمو		
یوآو گالانت، وزیر دفاع اسرائیل گفت که پاسخ اینکشور به حمله موش	یوآو گالانت، وزیر دفاع اسرائیل گفت که پاسخ این کشور به حمله موشکی ج سمیرا قرائی، ایران اینترنشنال		
باشگاه شباب الاهلی که تیم ملی فوتبال از دقایقی دیگر در است	برای تیم کرده استنکته اینکه در این پوستر علاوهبر عزتالهی و آزمون، شباب الاهلی صوی جهخش را  ر قلی قرار داده  وه ی ان اق    ، ی از احمال پیو ا  اشگامارای داوه د کاپیال ی ف فوت ای پ		
تیتر اول با نیوشا صارمی، سه شنبه ۲۴ مهر	تیتر اول با نیوشا صارمی، سه شنبه ۲۴ مهر		
از خاکستر  ژاپن، بخش دوم در این قسمت به یکی از معدود بازماندگ	از خاکستر  ژاپن، بخش دومدر این قسمت به یکی از معدود بازماندگان بمب ه یروشیما و جنگ اتمی سر میزنیملینک نسخه کامل برنامه در یوتیوب		
با اشاره به مشکل	محال مطلق، د یورای وورای  و  غذایی وه  کل کم کود ا شیوزی شی شی  شیو شی  شیر  ماو م  ف شه الاو ازود د جاری وجج ی ورای ط در وو		
پزشکیان از دستور خامنهای برای مقابله با تحریمها خبر داد بحر	پزشکیان از دستور خامنهای برای مقابله با تحریمها خبر دادبحران ا رشد حکمرانی		
نه خانوارها و پ	نیای خانوارها و پیامدهای منفی آن بر کیفیت زندگی و رفاه آنها خبر داد به نوشته این روزنامه مردم مجبور به حذف هزینههای رفاهی و مهاجرت به		
کمیسیون امنیت ملی مجلس، با اره به بدقولیها	حشمتالله فلاحتپیشه، رییس پیشین کمیسیون امنیت ملی مجلس، با اشار گفت روسها و چینیها برای قربانی کردن ایران دچار عذاب وجدان نخواهن د شداو افزود چین بیتفاوت است و		
ته واشینگتن پ	یکند پ		
با اشاره به تا	با  انی که به هر علت امکان ازدواج ندارند، و برای زوجینی که امکان فرز ندآوری ندارند، جنین را فریز میکنیم		
سی سال پیش در چنین روزهایی، جایزه صلح نوبل به رهبران اسرائیلی	پیش پیشر چ وز جایزایز  صلح ول و و الاسلی و فلی داداد ا ز تلاش و د ر اشی ، ایرال ایتووور ب در  پی امروز  ک آ واق تاریخی و رخایه پ		
مهای اتحادیه	کمیته حقوق بشر و کمکهای بشردوستانه پارلمان فدرال آلمان از تحریم های اتحادیه اروپا علیه جمهوری اسلامی استقبال و در بیانیهای اعلام ک رد قرار گرفتن سپاه پاسداران در فهرست گروههای تروریستی ضروری استاح مد صمدی، ایران اینترنشنال گزارش میدهد		
گروه دختران امت واحده در نامهای با عنوان آرام جان رهبر اش	گروه دختران امت واحده در نامهای با عنوان آرام جان رهبر ضمن اشاره به روز جهانی دختر به درگیریها در غزه و لبنان اشاره کرده و خطاب به   دختران شما از مامن جمهوری اسلامی ایران در اطاعت از حکم واجب شرعی  شما تا پای جان ایستادهایم		
نشریه آتلانتیک در گزارشی، سیاست خارجی جمهوری اسلامی را سیاستی	آتلانتیک در گزارشی، سیاست خارجی جمهوری اسلامی را سیاستی خورده و فروپاشیده خواندگفتوگو با سمیرا قرایی و اردوان روزبه، ایر ان اینترنشنال		
مسئول سابق روابط بینالملل سپاه، میگوید، در شرایط فعلی، جنگ ج	مسئول سابق روابط بینالملل سپاه، میگوید، در شرایط فعلی، جنگ جمگ ری اسلامی و شبهنظامیان وابستهاش با آمریکا اجتنابناپذیر است  رنشنال		
فت کسانی که می	قال ، م م اج لله ل  گ گوه قوی خوی خ و گ گ ک  ماو ازود  ب یک پ فلل  فوو  پروژ ایرالی و ار ای در حمای ف  است		
حسن رحیمپور ازغدی، عضو شورای انقلاب فرهنگی، با بیان اینکه امر	حسن رحیمپور ازغدی، عضو شورای عالی انقلاب فرهنگی، با بیان اینکه ام روز تمام دنیا از غزه، لبنان و در راس آن ایران میگویند، گفت با اطلا		
بر اساس اعلام مقامهای پلیس راه، در حادثه برخورد یک کامیون با	بر اساس اعلام مقامهای پلیس راه، در حادثه برخورد یک کامیون با تاکس ی پراید در کرج تعدادی دانشآموز کشته و مجروح شدند به گزارش خبرگزاری تسنیم، از چهار سرنشین این تاکسی که همگی دانشآمو		
مهدی چمران، رییس شورای شهر تهران، در خصوص وضعیت آلودگی هوای پا	مهدی چمران، رییس شورای شهر تهران، در خصوص وضعیت آلودگی هوای پایتخت ، گفت من دلم را خوش نکردم که اوضاع هوای این شهر خوب خواهد شد، شما هم ن کنیداو افزود باید تمام نهادهایی که در بحث آلودگی هوا دخیل هستند را جمع کنیم و یکبار دیگر مسئولیتهایشان را به آنها یادآوری کنیم		
به نظر شما دیدار ایران و قطر در مقدماتی جام جهانی ۲۰۲۶ با چه	ایرال ایتورزشی ورزشی شما یار ا و قطر ق  جام ب ب ب ب چ     ایرا       قطر		
باشگاه پرسپولیس تصاویری را از اولین حضور کریم باقری در باز	فنی    آخرین حضور باقری روی نیمکت پرسپولیس به دیدار با استقلال در فینال جا م حذفی فصل ۰۲۱۴۰۱ برمیگردد		
رناتا آلت، رییس کمیته حقوق بشر پارلمان آلمان، در بیانیهای که	آلت ،  ک قوق شارل آلما یاوهای که ی آ ب د در   ارار ر ف  گروه ت اروپا شد		
ی شانگهای، از ام	بیست و سومین نشست شورای روسای دولتهای کشورهای عضو سازمان همکاری ش ینترنشنال گزارش میدهد		
رئیس شبکه رادیو و تلویزیون دولتی ترکیه، تیآرتی گفت قصد دارد	رئیس شبکه رادیو و تلویزیون دولتی ترکیه، تیآرتی گفت کردن تاسیس کند این اظهارات محمدزاهد سوباجی، با واکنش جمهوری اسلامی و برخی احزاب ینترنشنال		
ید، در شرایط فع	وزیر اقصاد دولت ، ب ا اذو  دولت گر گروگو  آرش حوز  ، روز		
امشب در برنامه کامبیز حسینی بهطور ویژه به ماجرای گمشدن و ی	امشب در برنامه با کامبیز حسینی بهطور ویژه به ماجرای گمشدن و پید اشدن و پنهانشدن اسماعیل قاآنی فرماندهی سپاه قدس میپردازیم شتهشده یا بهدلیل جاسوسی در بازداشت است، تا اینکه امرک تشییع نیلفروشان از قاآنی رونمایی شد بهنظر شما قاآنی کجا بود    د تا لینک شرکت در برنامه امشب برایتان ارسال شود تلفن برنامه۰۰۴۴۷۵۱۰۱۱۰۱۱۰		
اپیمایی کشوری،	درپی الام لغو تمی پ بوه کشورهای اروپ از وی ویما رواز ها د		
مالی نفت از سوی	لی نفت از سوی ایران در صورت حمله اسرائیل، پوشش داده خواهد شد این آژانس تاکید کرد بازار نفت در غیاب اختلال عمده، در سال جدید با ما قابل توجهی مواجه است		
تاریخ دموکراسی  آمریکا	تاریخ دموکراسی  آمریکا جنگ داخلی و مبارزه برای آزادی		
نیویورک تایمز گزارش ارتش اسرائیل در جنگ غزه، از شهروندان فل سط	نیویورک تایمز گزارش داد، ارتش اسرائیل در جنگ غزه، از شهروندان فلسط ینی به عنوان سپر انسانی استفاده کرده است بردیا افشین، ایران اینترنشنال از جزئیات این گزارش میگوید		
تیم ملی فوتبال ژاپن در هفته چهارم رقابتهای انتخابی جام جه	های انتخابی جام جهانی ۲۰۲۶ برابر استرالیا به تساوی ۱۱ رسید		
رییس کمیسیون اروپا با ارسال نامهای به سران اتحادیه اروپا از ت	کیم یا قربانی، خبرنگاران ایراناینترنشنال		
بررسی روزنامههای امروز ایران، سهشنبه ۲۴ مهر با محمد رهبر، ای	بررسی روزنامههای امروز ایران، سهشنبه اینترنشنال		
ازه عباس نیلفروش	حاجیصاقی، قی، خا خ ی در  در  شیی ج از ولفوش م م م م م م  گاه گلفلفوش ، ع صرالل آرزو بود		
یوآو گالانت، وزیر دفاع اسرائیل گفت پاسخ ما به ایران نزدیک، د	یوآو گالانت، وزیر دفاع اسرائیل گفت پاسخ ما به ایران نزدیک، دقیق و ک شنده خواهد بوداو تاکید کرد که تشدید تنش از سوی حزبالله لبنان شم		
یکسال پس از قتل مهرجویی و همسرش سرنوشت این پرونده به کجا رسی	یکسال پس از قتل مهرجویی و همسرش وش ای پروولد ر با ک ح آ آ آی وزوز  و و و و تلگ  اجما طه و  طول پیگیری پرولد پ ققل کومی ، ، ،  پروش ققل قوش مهرجو و و وی		
تیم ملی فوتبال درحالی چهارمین مسابقه خود در مرحله سوم انتخ	میزبانی از ایران از سوی فیفا پس از حمله جمهوری اسلامی به اسرائیل باع ث شده شاگردان امیر قلعهنویی در امارات از قهرمان آسیا میزبانی کنندتوضیحات محمد تقوی، ایران اینترنشنال		
حسین عبدالهی، عضو کمیته انضباطی فدراسیون فوتبال، درگفتو گ	عبدالهی، عضو کمیته انضباطی فدراس یون فوتبال، در گفتوگو با خبر ورزشی از محرومیت چهار ماهه و جریمه ۵۰۰    به اطلاع فدراسیون رسیده استاین حکم درحالی صادر میشود که فکری ر وز گذشته در مصاحبه با خبر کرده بود ز مصاحبه اخیر بنده برداشتهای مختلفی شد در این مصاحبه، منظورم به شخص خاصی نبود و اسمی هم از کسی نبردم و در وا قع کلیگویی کردم بابت نوع گفتار بنده در این مصاحبه، که بعضا باعث رنجش اهالی فوتبال ش  واکنش به اظهارات همجنسگر استیزانه محمود فکری در یادداشتی نوشته بود با		
سیمای جمهوری اسلامی بامداد سهشنبه، ۲۴ مهر، گزارش ورود جن ازه	ی جمهو الامی   س شوه ، م ه گام گزارش ورود ج وه وولفشاوشاوش ، موم ولیاه پال  ، ق  ز چهره ال قاآلی، فرماد  ولوی ق پالا رووو ک وی قاضیز د ی ی		
عنوان قتل حکومت	وان قتل حکومتی خواهند ایستاد و اعتراض خود را علیه این کشتار سیستماتی ک ادامه میدهد کارزار نه به اعدام از مرداد ماه گذشته در زندان اوین آغاز شده استگفت		
این کشور را منفج	کشور را منفجر و تخریب کرده است کرا ی همیشه مسدود خواهد کردگفتوگو با توماج طاهباز، ایراناینترنشنال		
سفرهای پی در پی مقامهای حکومت ایران به لبنان، فضای خشم و کینه	سفرهای پی در پی مقامهای حکومت ایران به لبنان، فضای خشم و کینه از ج مهوریاسلامی را در این کشور به دنبال داشته است  در  میگویویوید جمهوریالا و ل		
رنامه عملیاتی ا	مه عملیاتی اسرائیل به دولت لبنان داده، ارتش این کشور قصد دارد عملیات ی محدود در عمق سه کیلومتر در جنوب لبنان انجام و آنجا را از نیروی حزب رنشنال		
ی شانگهای از امر	بیست و سومین نشست شورای دولتهای کشورهای عضو سازمان همکاری ش انگهای از امروز در اسلامآباد آغاز به کار میکند    گو با جواد همدانی، ایراناینترنشنال		
یک روز پس از اعلام تحریمهای اتحادیه اروپا علیه شرکتهای هواپی	های اتحادیه اروپا علیه شرکتهای هواپیمای ی ایران، شرکت هواپیمایی ایرانایر پروازهای خود را به مقصدهای لندن، پاریس و کلن لغو کردگفتوگو با احمد صمدی، ایراناینترنشنال		
مسعود پزشکیان، رییسجمهور جمهوریاسلامی میگوید در دیدار با لی	اسلامی تحریمها گفتوگو ده است اجرایی کردن توافق با چین و روسیه از راه حلهای رفع مشکلات اقتصادی ع نوان شده استگفتوگو با علی شیرازی، ایراناینترنشنال		
واستار توقف فوری	بریتانیا، فرانسه، آلمان و ایتالیا با انتشار بیانیهای مشترک، خواس    گو با نیلوفر پورابراهیم، ایراناینترنشنال		
در ویدیویی که رسانههای اجتماعی از مراسم تشییع جسد عباس نیلفر	در ویدیویی که رسانههای اجتماعی از مراسم تشییع جسد عباس نیلفروشان منتشر کردهاند فردی وسایل شخصی حاضران را به تابوت او میمالدعباس نیلفروشان، معاون عملیات سپاه پاسداران، کنار حسن نصرالله در حمله ششم مهر اسرائیل به بیروت کشته شد		
با اعلام سایت ایافسی، دیدار استقلال و النصر در لیگ نخبگا	ورزشگاه بنراشد شهر دبی برگزار خواهد شد     ، ا قلال و ال و تاوی بمی  ش اماکور پ  ی فوت آ ، میزی را وا  جا ک		
شمارش  کالج انتخاباتی و ایالات سرنوشتساز کالج انتخاباتی چیست	شمارش  کالج انتخاباتی و ایالات سرنوشتساز کالج انتخاباتی چیست و چه تاثیری در انتخابات ایالات متحده آمریکا دارد در این قسمت از شمارش به این موضوع میپردازیم		
گوهر خیراندیش در اولین سالگرد قتل داریوش مهرجویی و همسرش اشار	گوهر خیراندیش در اولین سالگرد قتل داریوش مهرجویی و همسرش با اشاره ب ه مرگ برخی هنرمندان که به دلیل لجبازی و نرسیدن به موقع واکسن کرونا از دنیا رفتند، گفت حتی جان کارگران معدن هم گویا جان انسان ارزشی ندارد		
۵۶ سال پیش در چنین روزی، دیدیه دشان، سرمربی تیم ملی فوتبال	ربی تیم ملی فوتبال فرانسه، متولد شد    ام جهانی قهرمان شده است پس از زاگالو و بکنباوئر، دشان سومین فرد در تاریخ فوتبال است که به		
شاتر  مروری بر آثار هنر اعتراض	شاتر  مروری بر آثار هنر اعتراض		
گزارشها، زندانیان ۲۲ زندان شامل اوین، قزلحصار، مرکزی کر ج، ته	گزارش ، زیالیاو زدال شامل ا ، قزلصار م م ک ، لاکال رش ، قائ ، ارد ، ت ت ، س س سلما ،وی، ، قز، قز، قز،  بانه، مریوان و کامیاران، در کارزار سهشنبههای نه به اعدام در اعت صاب غذا هستند		
حسین رضازاده، قهرمان پیشین جهان و المپیک که پیشاز تالاخاد	بود، در گفتوگو با خبرآنلاین میگوید سرشیر و عسل اردبیل برای او ما نند دوپینگ، نیروزا بوده استرضازاده همچنین میگوید یا اباالفضل  دوپیگ اصلی او وده و  یک کوه کر  ج ت ج ت درحالی ک  بلیل  ی  دوا فر  خود وز   الاداد از ای ذک ش از  کشاله راومصوم شوم شو و وری پایی		
تیم فوتبال خاتون بم، تنها نماینده ایران در مسابقات لیگ قهر	در مسابقات لیگ قهرمانان زنان آسیا، پس از صعود به مرحله یکچهارمنه گرفت ایسنا		
کمیته انضباطی فدراسیون فوتبال آرای مربوط به بازیهای هفته	های استقلال، هوادار، خیبر خرمآباد، پرسپولیس، چادر ملو، فولاد خوزس    ۱۱۰ میلیون تومانخیبر خرمآباد به دلیل نقض اصول کلی، ۲۰ میلیون تو تماشاگرانس    تومانحامد طباطبایی، مربی چادرملو، بهدلیل غیرورزشی، ۶۰ میلیون تومانباشگاه تراکتور بهدلیل رفتار تماشاگران و همچنین ورود دیرهنگام به زمین، ۱۴۰ میلیون تومانایگور پوستونسکی، بازیکن تراکتور، بهدلیل خودداری از اجرای دستور داور، ۲۰ میلیون تومانباشگاه فولاد لیل تاخی میلیوول توما  ال  لال خوز   مشاور او ، ، ، ،لیل  غیورزشی، ۲۰ ی میل ت		
دلایل واکنش نشان ندادن سریع اسرائیل به حمله جمهوریاسلامی و آخ	دلایل واکش  الائی  جمله ج جمهو آخری خ ج  ز ز ل و الش الا ا  ص ص ص ص ص فایی، ایرالایت		
ر آهن تهران در	محمجواد خوی، ش   ۱۸ ۱۸  ، آوص آ   و آهرا ماآ گ گ گ ش  آ  شاآ را ورا ک و و  موق کریم ، گ موضو  ا ض ی ایک یچ گووو ی    اریا ش  صورت نگرفت		
سرخط خبرهای سهشنبه، ۲۴ مهر	سرخط خبرهای سهشنبه، ۲۴ مهر		
در کنار حسن نصر	مرا  شیی ج  ولفروشاوش ، م م م  پ پا پر ک ک     صورل ی مرا  ورخی ف ، ، ، جمله ال  قاآ فاآرما یو قاه پاه پالاه پال  پ پ پا ضور ضور ش شاشد		
این کشور را منفج	کشور را منفجر و تخریب کرده است کرا ی همیشه مسدود خواهد کردگفتوگو با توماج طاهباز، ایراناینترنشنال		
هی خود را تسویه	ز  ش زهرا کورد ک   ک قور ش  دارد و ی  ز، پرداخ ک  ای اطلا  ، ب ب ب د کال ش شویژ ی ظر گرف ش  تا  و و و و و و و و		
عنوان قتل حکومت	وان قتل حکومتی خواهند ایستاد و اعتراض خود را علیه این کشتار سیستماتی ک ادامه میدهد کارزار نه به اعدام از مرداد ماه گذشته در زندان اوین آغاز شده استگفت		
زایش بسیار قابل	واشیگو ، روز دوشوشوه ۲۳ م م گز دارله ازایش یاوج  فروش  ایراوی جمهو دولت جو  خ خاد و و ش ال اری الق ولت ورآوردهای کارش ، ،رآمد  غیرقاو ک ی دولت  ب د ۲۰۰ میلیارد دلار رسید		
سیمای جمهوری اسلامی بامداد سهشنبه، ۲۴ مهر، گزارش ورود جن ازه	ی جمهو الامی داد  ، ، م م ه هام گزارش ورود ج وه وولفوشال ، مو تاه پال  ، ق ای ایاق اق اقایاق ز چهره ال قاآلی، فرماد  ولوی ق پالا رووو ک وی قاضیز د ی ی		
یک شبکه استرالیایی از زندانی بودن دست کم دو شهروند استرالیایی	یک شبکه استرالیایی از زندانی بودن دست کم دو شهروند استرالیایی در زن رنشنال		
دانشگاه جورج واشینگتن در گزارشی تصاویری از کامالا هریس، نامزد	سلامی منتشر کرده است الهی پیوندهای عمیقی با جمهوریاسلامی داردگفتوگو با امید معماریا ن، روزنامهنگار		
دنیل مالدینی بعد از پدرش پائولو و پدربزرگش چزاره اسطورهها	ایرال ایشورزشی مالیی  د از پولو   چزاره ا  ی فوتوت ای ،  ا  ی یم ملی ای کشور و میال رف    لیا، مطرح شده است		
یک بستنیفروشی در شهر میلان برای ایجاد طعمهای جدید از چت جیپ	یک بستنیفروشی در شهر میلان برای ایجاد طعمهای جدید از چت جیپی تی استفاده میکند حتی مشتریانی که به نقش هوش مصنوعی در بستنی محبوب خود شک داشتند بعد ا ز امتحان کردن این بستنی به آن علاقمند شدندگزارش کیمیا قربانی، ایران اینترنشنال		
با اشاره به این	کارشناس محور مقاومت در برنامهای در صدا و سیمای جمهوری اسلامی با  ی شروع شد، گفت خیلی از مردم ضاحیه میگفتند شاید اگر به کشته شدن امیر عبدادیم الان حسن نصرالله زنده بود		
ی که در برنامه م	وزارت خارجه استرالیا در بیانیهای از ممنوعیت سفر برای پنج ایرانی ک ه در برنامه موشکی جمهوریاسلامی مشارکت داشتند، خبر دادگفتوگو ع لیرضا محبی، ایراناینترنشنال		
واشینگتن پست به نقل از دو مقام گزارش داد که بنیامین نتانیا هو	گزارش داد که بنیامین نتانیاهو در گفتوگوی هفته گذشته خود با بایدن به آمریکا اطلاع داده که اسرائیل در حمله تلافیجویانه خود مراکز نظامی جمهوریاسلامی را هدف قرار می دهدگفتوگو با شایان سمیعی، کارشناس امنیت ملی		
پس از دو هفته غیبت و شایعه، اسماعیل قاآنی در سکوت، در سیمای جم	پس از دو هفته غیبت و شایعه، اسماعیل قاآنی در سکوت، در سیمای جمهوری ا سلامی ظاهر شد چنین وانمود شد که او به همراه جنازه عباس نیلفروشان به تهران بازگشته استگفتوگو با جمشید برزگر، روزنامهنگار		
سرخط خبرها، سهشنبه ۲۴ مهر	سرخط خبرها، سهشنبه ۲۴ مهر		
شهروندان با ارسال ویدیوهایی به ایراناینترنشنال از گرانی کم ب	شهروندان با ارسال ویدیوهایی به ایراناینترنشنال از گرانی و کمبو د دارو گلایه میکنندشهروندی میگوید از قیمت دارو بهشدت شوکه شدم چه خبر است لعنت به تو خامنهای		
درباره حمله تلاف	دفتر نخستوزیری اسرائیل در بیانیهای اعلام کرد که تصمیمگیری درب اره حمله تلافیجویانه علیه ایران بر اساس منافع ملی گرفته اهد شددر این بیانیه آمده که اسرائیل دیدگاه آمریکا را در نظر		
چهار منبع موثق از حزب لیبرال کانادا به گلوب اند میل گفتند، نما	چهار منبع موثق از حزب لیبرال کانادا به گلوب اند میل گفتند، نمایندگا ن لیبرال در پی تغییر رهبر این حزب هستند محبوبیت جاستین ترودو در ۹ گذشته در پایینترین وضعیت خود گرفته اما او اعلام کرده که قصد و نداردگزارش مهسا مرتضوی، ایران اینترنشنال		
سرویسهای امنیتی آلمان نسبت به افزایش جاسوسی و خرابکاری روسیه	ین کشور هشدار دادندجزئیات بیشتر در گزارش علی حسنپور، ایران اینترن شنال		
پنج فرد ایرانی خ	الالیا از الال تریم ی هد مالی و و ی ی  ی ووه پ ایرالی خ خاد ای   وشکیوشکی ال  می ارک دار الالیا   الامی را تهیی ج ی امی  و جهال داوه الارش ای ال		
کاخ سفید اعلام کرد که آمریکا سالهاست که تهدیدات جمهوری اسلامی	کاخ ی الام ک حمل  ایرال ولی شهرو آ آایی واقواق می  خواهد ش ک ازود کود کود تهی ی جمهو ی  اله		
سیمای جمهوری اسلامی، بامداد سهشنبه ۲۴ مهرماه، گزارش ور ود جن	سیمای جمهوری اسلامی، بامداد سهشنبه ۲۴ مهرماه، هنگام گزارش ورود جنازه عباس نیلفروشان، معاون عملیات سپاه پاسداران، برای دقایقی چهره اسماعیل قاآنی، فرمانده نیروی قدس سپاه پاسداران، را نشان داد		
نازه عباس نیلفر	سیمای جمهوری اسلامی، بامداد سهشنبه، ۲۴ مهر، هنگام گزارش ورود جنا زه عباس نیلفروشان معاون عملیات سپاه پاسداران، برای دقایقی چهرما عیل قاآنی، فرمانده نیروی قدس سپاه پاسداران را نشان داد آخرین باری که اسماعیل قاآنی در رسانهها مشاهده شد، ۹ مهرماه، دو رو ز پس از کشته شدن حسن نصرالله دبیرکل حزبالله لبنان در حمله هوایی اسر   قاآنی در آن زمان به دفتر نماینده حزبالله در تهران رفت پس از آن هیچ خبر و عکسی درباره اسماعیل قاآنی منتشر نشد غیبت او در نماز جمعهای که به امامت علی خامنهای برگزار شد، بر دام نه سوالات درباره سرنوشت قاآنی افزود در حالی که   اا احمال کش او ک ه  ص ص ، ، ، میل ای آی، ور ز ب  قطومت قط ه ه ف  خور داد کاآی بازاشاش و و و ومی ج		
رسانههای جمهوری اسلامی خبر دادند که جنازه عباس نیلفروشان، معا	رسانههای جمهوری اسلامی خبر دادند که جنازه عباس نیلفروشان، معاون عملیات سپاه، که دو هفته پس از کشتهشدنش در بیروت پیدا و به بغداد برده شده بود، بامداد سهشنبه وارد تهران شداو به همراه حسننصرالله، در ستاد فرماندهی حزبالله در ضاحیه در حومه جنوبی بیروت کشته شد		
ویدیوی منتشرشده در حالوش حاکی از پیدا شدن تکههای سقوطکرده	کرده یک موشک در روستای احمدآباد از توابع شهرستان لاشار در استان سیستان و ب گزارش حالوش، این موشک صدای مهیبی داشته و از محل دقیق راکنون		
بر اساس جدول زمانبندی پروازها در فرودگاه امام خمینی تهران،	بر اساس جدول زمانبندی پروازها در فرودگاه امام خمینی تهران، پرواز های روز سهشنبه هواپیمایی ایرانایر به مقاصد اروپایی از جمله لندن، پاریس و کلن، لغو شده استطبق این جدول پروازهای ایرانایر و سایر شرک ت های هواپیمایی به مقاصد غیر از اتحادیه اروپا طبق برنامه الجام خواد شز دوش  اتای  ، س شه شرک هواپیمایی س ، ما و ایرایای را دلیل ال  شک ی ی		
اتحادیه اروپا هفت مقام و هفت نهاد وابسته به جمهوری اسلامی از ج	ایایه ا ف مق و و  وهف وه جمهوری الامی از جمله ش هواپیمایی ایرال و  رال   ت ها وهلیل   از جمهوری الامی وه رو الال ش  ا گز گزارش  ولوف		
سه هفته مانده به انتخابات ریاست جمهوری آمریکا، براساس بعضی نظ	سه هفته مانده به انتخابات ریاست جمهوری آمریکا، براساس بعضی نظرسن  ایران اینترنشنال		
ویدیوهای منتشرشده در شبکههای اجتماعی نشان میدهند جمعی ز با	ویوهای  مر ش ش  اجمای   جم ج ازشال  در اوراض وه دم وه  شاوزوشوش ب م مهر در ش ی مخخلف ایرال جم ک و شو ش چ چووو  ش ش ،ور ک ، ، ف ت ب جال مردم و ستاد اجرایی، حق ماها رو خورده سردادند		
پس از انتشار گزارش واشینگتنپست مبنی بر اینکه اسرائیل به آمریک	پس از انتشار گزارش واشینگتنپست مبنی بر اینکه اسرائیل به آمریکا اط لاع داده که صرفا به تاسیسات نظامی ایران حمله خواهد کرد و نه تاسیسات ن یمت نفت برنت هر بشکه به حدود ۷۵ دلار و نفت وست تگزاس به بشکهای ۷۲ دلار رسید		
ویدیوهای منتشرشده در رسانههای اجتماعی حاکی است شامگاه دوشنب	وی  خرمش  کوط کرد ا  گزارشی د علت  حاثاث  و ا ب ج جرثقیل ج ج ت پاثاث ججج خرمشهر در روز ۱۲ مهرماه سقوط کرده بود		
گیلا گملیل، وزیر علم و فناوری اسرائیل، با بیان اینکه در مورد	گیلا گملیل، وزیر علم و فناوری اسرائیل، با بیان اینکه در مورد مسئله هستهای ایران باید با تدبیر عمل کنیم، گفت اسرائیل برای تضمین امنیت واکنش قاطعی به حملات ایران نشان خوا هد داداو افزود جمهوری		
مراد ویسی، ایران اینترنشنال جنگ با آمریکا و اسرائیل با جنگ با	مراد ویسی، ایران اینترنشنال جنگ با آمریکا و اسرائیل با جنگ با عراق فرق میکنددرباره جنگ با عراق میتوان گفت صدام به ایران حمله کرد م کردند، ضروری با آمریکا و اسرائیل بشیم		
مراد ویسی، ایران اینترنشنال وزیر خارجه جمهوری اسلامی گفت تباد	مراد ویسی، ایران اینترنشنال وزیر خارجه جمهوری اسلامی گفت تبادل پی       ان را برای شلیک آماده میکنند		
مراد ویسی، ایران اینترنشنال هنوز اسرائیل حمله نکرده همه قیمت	مراد ویسی، ایران اینترنشنال هنوز اسرائیل حمله نکرده همه قیمتها ر ایران در حال افزایش است این یعنی بازار دارد صدای جنگ را میشنود مردم ایران همه جوره هزینه جنگطلبی خامنهای و سپاه را میپردازند و در شرایط کسری بودجه باید هزینههای جنگ جمهوری اسلامی را هم بدهند		
سیاست با مراد ویسی  ۲۳ مهر ۱۴۰۳  ۱۴ اکتبر	سیاست با مراد ویسی  ۲۳ مهر ۱۴۰۳  ۱۴ اکتبرنسخه صوتی برنامه سیاست با مراد ویسی سایه شوم جنگ جدید جمهوری اسلامی بر ایران		
حزبالله عصر دوشنبه سه راکت به سوی اسرائیل کرد که آژیر خطر را	ز  عصوشوش  راک وه  الائی کلیک ک  ک ا قی، ای		
در تماس اخیر به ج	واشیگ ول از دو مقام مطل گزارش بادامی  داهو د ج جو و  گ قص دارد بمل  ول  یا  د باي تات   حمله ک طبق این گزارش نرمش ظاهری در موضع نتانیاهو در تصمیم بایدن برای ارسال		
منتشر کرده که	دالشگاه جورج واشی گزارش جج د افرایی آمریکا ملش ک  آ صاوی یرالی الاصل یکی یکی مراکز جمهو الامی یه میشوگوگوگوگوگوگوگوگوگوگوگوز ، ایرال ای		
وزیر خارجه جمهوری اسلامی به دلیل شرایط خاص منطقه زمینه گفت	وزیر خارجه جمهوری اسلامی به دلیل شرایط خاص منطقه زمینه گفتوگو وج ود ندارد عراقچی مذاکرات ایران و آمریکا با میانجیگری عمان فعلا متو قف شده است گفتوگو با علیرضا نامور حقیقی، تحلیلگر مسائل سیاسی		
محسن اراکی، عضو مجمع تشخیص مصلحت نظام، گفت جامعه روحانیت نمی	گفت د در مقابل درد و رنج مردم ساکت باشند زیرا جامعه روحانیت بخشی از جامعه		
را در واکنش به ا	ادیه قرار دادگفتوگو با دامون گلریز، تحلیلگر اموربينالمللم درس دانشگاه لاهه		
امشب در برنامه باکامبیز حسینی در یکسالگی قتل داریوش مهرجویی	وح یده محمدیفر مروری کردیم بر این قتل فجیع و پروندهی آن		
هادی چوپان، نایب قهرمان مسترالمپیا ۲۰۲۴ در گفتگویی، به داو	۴ در گفتگویی، به داوران این مسابقه تاخت و گفت ما به حساب این هستیم ڇ رگ باشی و وزن زیاد داشته باشی به هر صورت نظر داوران این بود و حرفی هم نیست که من بزنماو درباره آینده گفت تصمیمات جدیتری میگیریم ما هم گیج هستیم و نمیدانیم مسترالمپیا چه چیزی از ورزشکاران میخو اهد که ما همان را بیاوریم اگ   ال ما وریم اما ک چیزیور مورد ب خ ، و و و و و و و و و  کاود چوپاوپ  م  ق ی را ج  وور اول  این رقابت را هرکسی ببرد، اسمش در تاریخ نوشته میشود و تعدادش مهم نی ست من از خودم راضیام چون تلاش خودم را کردم نیازی نیست ناراحت باشم بهخاطر اینکه داوران نظرشان با من متفاوت بو د		
برنامه با کامبیز حسینی  ۲۳ مهر ۱۴۰۳  ۱۴ اکتبر	برنامه با کامبیز حسینی  ۲۳ مهر ۱۴۰۳  ۱۴ اکتبر نسخه صوتی برنامه با کامبیز حسینی چهکسی دستور قتل مهرجویی را داد		
ش مصنوعی گفت که ح	کارشناسی ارشد یا دکتری در یک پروژه کلان هوش مصنوعی زیر نظر بنده بهص ورت شخصی در حال فعالیت هستند که این یک قلمروی جدیدی است		
دامات خرابکار	شینبت و پلیس اسرائیل اعلام کردند دو اسرائیلی به اتهام انجام اقدام ات خرابکارانه به نفع جمهوری اسلامی و همچنین برنامهریزی برای قتل یک شخصیت ارشد اسرائیل دستگیر شدند آنها در اقدامات خرابکارانه مثل اسپری کردن گرافیتیهای تحریکآ		
رگفتوگو با سای	ابراهیم رستمی، دبیر پیشین کمیسیون توسعه و تجهیز سپاه پاسداران در گفتوگو با سایت دیدهبان ایران با تاکید بر داشتن سلاح اتمی گفت که نیروهای نیابتی جمهوری اسلامی در حال حاضر در حال جنگ با اسرائیل هستند و ما تجهیزاتی در اختیار داریم که از سلاح هستهای قویتر است		
همزمان با نگرانی گروههای اسرائیلی مدافع حقوق بشر درباره طرح د	ز  ی گروه ی الائیلی مدافاف شو طرح دولت اس ی مح شمال غز از مش  الش و ال ا ت خ مرت قص الائیل ورای  غز  جی الی اوگوگوگوگوگوگ ، ، ، ، ، ، ، ، ،لیلگ  ا و  فولی  ئل خاور		
شارن هاسکل، نماینده مجلس در کنست اسرائیل دشمن اصلی ما جمهوری	شارن هاسکل، نماینده مجلس در کنست اسرائیل دشمن اصلی ما جمهوری اسلام ی است		
چین در مناطق شمالی، جنوبی و شرقی جزیره تایوان رزمایش نظامی برگ	چین در مناطق شمالی، جنوبی و شرقی جزیره تایوان رزمایش نظامی برگزار م یکند وزارت خارجه آمریکا این رزمایش غیرضروری، خطر تشدید تنش را به مراه دارد کارشناسان نظامی چین از دو حمله موشکی جمهوری اسلامی به اسر ائیل درس گرفته استگفتوگو با فرزین ندیمی، تحلیلگر امور دفاعی و امنیتی		
یم کرد شرکتهای	ایایه الوپا هف مقام و  وه وه ج جمهوری الامی را تری شرک ی هواپی ای ای  د حوم  ی ا  قرار گرفد ای توهلیلیل ال موشک زمهوری الامی وه رو ال ش  گ گوگو  ا چ ل رو		
ارتش کشورش عامدانه به نیروهای حاف ظ صلح سازمان ملل	بنیامین نتانیاهو، با رد اینکه ارتش کشورش عامدانه به نیروهای حافظ ص لح سازمان ملل در لبنان حمله کرده، ضمن ابراز تاسف از آسیب دیدن پرسنل ی ونيفيل گفت حزبالله از مواضع این نیروها به عنوان پوشش حملات استفاده میکند و بهترین راه برای تضمین ایمنی آنها خروج موقت از مناطق خطر است		
محمود فکری، سرمربی پیشین استقلال در گفتگویی با خبرورزشی ا	گویی با خبرورزشی از عمومی جامعه بابت اظهارات همجنسگراستیزانه د، عذرخواهی کرد از مصاحبه اخیر بنده برداشتهای مختلفی شد در این مصاحبه، منظورم به شخص خاصی نبود و اسمی هم از کسی نبردم و در وا قع کلیگویی کردماو گفته است بابت نوع گفتار بنده در این مصاحبه، ه بعضا باعث رنجش اهالی فوتبال شده، از عموم جامعه عذرخواهی میکنم محمود فکری، سرمربی کنونی مس شهربابک، ۱۰ روز پیش در اظهاراتی همجن نیمگار ستقلال گفت مدیران استقلال همه ارزشی هستند خواهش میکنم دنبال سرمربی همجنسگرایی که متاسفانه مفعول هم هستند، نروندپس از این اظهارات او از هرگونه فعالیت فوتبالی محروم شد باشگاه مس شهربابک هم از این اظهارات ابراز برائت کردهمچنین عباس وسوی، رئیس کمیته تدوین و تطبیق مقررات فدراسیون فوتبال در واکنش اظ هارات محمود فکری در یادداشتی نوشت با اینکه ذاتاً مخالف مجازاتهای بدنی هستم اما ۸۰ تازیانه حدی بابت چنین رفتاری را کیفری میبینم		
شبکه فاکسنیوز گزارش داد جو بایدن به شورای امنیت ملی آمریکا دس	شبکه فاکسنیوز گزارش داد جو بایدن به شورای امنیت ملی آمریکا دستور داد تا برای جمهوری اسلامی روشن کند که هرگونه تلاش برای آسیب به دونالد ترامپ به عنوان عمل جنگی در نظر گرفته خواهد شدتیم ترامپ اخیرا در پی گزارش تلاشها برای ترور او درخواست تمهیدات حفاظتی و نظامی بیشتر کرد		
تیم ملی فوتبال ایران و قطر فردا در مقدماتی جام جهانی ۲۰۲۶	استادیوم راشد شهر دوبی به مصاف یکدیگر برون د به نظر شما این بازی با چه نتیجهای به پایان میرسدبرای اظهارنظ		
پنتاگون خبر داد که ایالات متحده ۱۰۰ نیروی نظامی را به همراه سا	پنتاگون خبر داد که ایالات متحده ۱۰۰ نیروی نظامی را به همراه سامانه میکندگفتوگو با سمیرا قرایی،		
گفت که دوست داشته در سفر به لبنان خو دش خلبان پرواز ب	گفت که دوست داشته در سفر به لبنان خودش   او اشاره کرد حزبالله لبنان با وجود آسیب جدی که به آن وارد شده در ج بهه کار خود را انجام میدهد و هرروز مستحکمتر میشود		
علی صدرزاده، تحلیلگر مسائل خاورمیانه اگر اسرائیل تشخیص بدهد	علی صدرزاده، تحلیلگر مسائل خاورمیانه اگر اسرائیل تشخیص بدهد جمه وری اسلامی وارد جنگ با اسرائیل در بیروت شده، فراتر از توافقی که با آ مریکا داشته، عمل خواهد کرد		
جابر رجبی، فعال و تحلیلگر سیاسی باید دقت کنیم که حزبالله مم	جابر رجبی، فعال و تحلیلگر سیاسی باید دقت کنیم که حزبالله ممکن ا		
۲۴ با فرداد فرحزاد	۲۴ با فرداد فرحزاد		
۲۴ با فرداد فرحزاد	۲۴ با فرداد فرحزاد		
سخنگوی وزارت امر به معروف طالبان اعلام کرد اینگروه به تدریج قا	افغانستان ا خواهد کرداو به خبرگزاری فرانسه گفت که پخش تصاویر موجود زنده بر خلا ف اسلام است و باید مردم افغانستان را در این زمینه قانع کرد		
چشمانداز ۲۳ مهر ۱۴۰۳  ۱۴ اکتبر	چشمانداز ۲۳ مهر ۱۴۰۳  ۱۴ اکتبرنسخه صوتی برنامه چشمانداز شبه کودتای سپاه در حزبالله لبنان		
منشه امیر، کارشناس امور خاورمیانه ما وارد مرحلهای بسیار وخیم	منشه امیر، کارشناس امور خاورمیانه ما وارد مرحلهای بسیار وخیم از جنگ شدهایم از طرفی آمریکا برخلاف گذشته، سرباز به اسرائیل فرستاده و از طرف دیگر ممکن است ما شاهد آغاز پرتاب موشکهای نطقهزن از خاک لبنان به اسراي ٔیل باشیم		
ارتش اسرائیل یک مجموعه زیرزمینی نیروهای رضوان حزبالله را تص	ارتش اسرائیل یک مجموعه زیرزمینی نیروهای رضوان حزبالله را تصرف کر دکه شامل ۸۰۰ متر تونل در زیر یک روستای غیرنظامی است ملل یونیفیل ز شمالی خواند		
مسعود پزشکیان گفت که با علی خامنهای درباره تدوین لایحه بودجه	دیدا ر و گفتوگو کرده و خامنهای توصیهها و نکات لازم را در این زمینه به او داده است پزشکیان افزود که با خامنهای درباره راه برونرفت از فشار و تحریم		
فضاپیمای اروپا کلیپر دقایقی پیش به فضا پرتاب شد ماموریت این	فضاپیمای اروپا کلیپر دقایقی پیش به فضا پرتاب شد اررسی قمر اروپا استگفتوگو با پوریا ناظمی، روزنامهنگار علمی		
لامی تهدیدی بر	وزیر خارجه اسرائیل در گفتوگو با وزیر خارجه چین گفت که جمهوری اسلا می تهدیدی برای خاورمیانه و کل جهان است یسرائیل کاتز در تماس تلفنی با این مقامچین تاکید کرد که اسرائیل به مله موشکی جمهوری اسلامی پاسخ خواهد داد نیردند		
میزان ثبتنام رایدهندگان دموکرات در سه ایالت کلیدی پنسیلوانی	میزان ثبتنام رایدهندگان دموکرات در سه ایالت کلیدی پنسیلوانیا،  ایران اینترنشنال		
اتحادیه اروپا شرکتهای هواپیمایی ایرانایر، ساها و ماهان را، ه	لیل انتقال پهپادهای ایرانی و فنآوریهای مرتبط به روسیه، تحریم ک		
حمله گفتوگو با ح	حمله چطور رقم خورد و تا چه حد موفق بودگ فتوگو با حسین آقایی، پژوهشگر روابط بینالملل و امور استراتژیک		
نیویورکتایمز در گزارشی با استناد به گفتوگو با سربازان اسرائ	گایمز در گزارشی با استناد به گفتوگو با سربازان اسرائیلی و بازداشتشدگان فلسطینی، نوشت ارتش اسرائیل، زندانیان فلسطینی ما بور به انجام ماموریتهای خطرناک و کشنده کرده استگفتوگو با بردیا افشین، ایران اینترنشنال		
خود به عمان رفت	د به عمان رفت عراقچی بار دیگر موضع جمهوری اسلامی را درباره احتمال جنگ با اسرائیل ميان، تحلیلگر جهان عرب		
به جنگ دستان	تعدادی از زنان محبوس در زندان اوین، اعلام کردند آن دم که برای نه به جگر نه به اعدام را فریاد نکنیم،  یه قتل حکومتی میایستیم و نه به کشتار سیستماتیک را فریاد میکنیم		
حزبالله عصر دوشنبه سه راکت به سوی اسرائیل کرد که آژیر خطر را	حزبالله عصر دوشنبه سه راکت به سوی اسرائیل شلیک کرد که آژیر خطر را ا بابک اسحاقی و سمیرا قرایی، خبرنگاران ایران اینترنشنال		
تیتراول با نیوشا صارمی، دوشنبه ۲۳ مهر	تیتراول با نیوشا صارمی، دوشنبه ۲۳ مهر		
فت من از میانه	محمدباقر قالیباف، رییس مجلس، در اجلاس بینالمجالس جهان در ژنو گفت من از میانه خرابههای بیروت آمدم و صدای مردم لبنان هستماو افزود ه کشورهای حامی اسرائیل توصیه میکنیم کمکهای اطلاعاتی، سیاسی و صادی به اسرائیل را پایان دهند چرا که آنها رو به زوال هستند		
اسلامی به دلیل ا	وزیر خارجه اوکراین از تحریمهای جدید اتحادیه اروپا علیه جمهوری اس استقبال کرد و گفت کم نظامی یک متجاوز، قوانین بینالمللی و منشور سازمان ملل را نقض میکند کسانی که از تجاوز حمایت میکنند باید مسئولیت آن را بپذیرند و هزینه اش را بپردازند		
ه طلا از ۵۰ میلی	نفت از بنادر ایران در خلیج فارس به شدت کاهش یافت، قیمت سکه لا از ۵۰ میلیون تومان رفتگفتوگو با رضا غیبی، روزنامهنگار ا قتصادی		
دارون عجماوغلو، برنده اقتصاد امسال، پیشتر در مصاحبه با ران ای	ا محمد ماشینچیان، پژوهشگر ارشد حکمرانی		
مستند انتخابات ریاست جمهوری امریکا  کامالا هریس و ایران در ای	مستند انتخابات ریاست جمهوری امریکا  کامالا هریس و ایران در برنا ایران هریس		
در پی افزایش تنش نظامی بین اسرائیل و حزبالله لبنان، طرح جدید	د پی از ایش تش   الائیل و ز   ،رح ج یواوگال فل تهرا ر    الائیرائیل هشار داده ش  ا  جای ام ورای زگی		
نصرالله در بیرو	استان نماز میت خواهد خواند		
فرماندهان سپاه ح	اندهان سپاه حملات اخیر این گروه را رهبری میکنند    بالستیک ایرانی، عراقچی سربازان آمریکایی را به مرگ تهدید کردگزارشی از مجتبا پورمحسن		
شروبات الکلی تق	دا وم پزشکی گیلال الا کم شم جالو    ال ق ای اوه ۱۸ ول ازایش یا ز ار هم علائم ض ، ی یالی، شک شکم و تاری ی مصرف مشرو ت الکلی ولی در اا   مراج ج ج ج ججج کردهاند		
با وجود این که نظرسنجیهای ملی آمریکا، همچنان از پیشتازی کامال	با وجود این که نظرسنجیهای ملی آمریکا، همچنان از پیشتازی کامالا هر یس، نامزد دموکراتها خبر میدهد، اما براساس بعضی نظرسنجیهای ایال تی، دونالد ترامپ دستکم در سه ایالت چرخشی از رقیب خود پیشی گرفته استگ ایران اینترنشنال		
و یکصد نیروی نظا	سخنگوی پنتاگون اعلام کرد ایالات متحده، سامانههای ضد موشکی تاد و ی و گروههای نیابتیاش، به اسرائیل اعزام خواهد کردگفتوگو با سمیرا قرایی، ایران اینترنشنال		
هریس با محمدعلی	هر گروهها ی فلسطینی، حزبالله و جمهوری اسلامی را منتشر کرده و نسبت به آن واکنش نشان دادهاند دیدار و از کردنیویورکپست با انتشار تصویر دار هریس و الهی نوشت این روحانی در مرکز کارزار نفوذ رژیم قاتل قرار د اردتصاویر این دو دیدار در رسانههای اجتماعی نیز منتشر و با واکنش کاربران مواجه شده است الهی به عنوان رهبر موسسه اسلامی دارالحکمه در میشیگان فعالیت میکن د       ی برگزار میکنداین روحانی شیعه زاده ایران، سابقه فعالیت برای انقلا ب سال ۱۳۵۷ و تحصیل در حوزه علمیه در اصفهان را داشته و همچنین با حکم دفتر خمینی مسئول انجمن اسلامی نیروی دریایی و بعدها موسس دفتر پژوهشهای بنیاد شهید بوده است    شت		
ویدیوی رسیده به ایراناینترنشنال نشان میدهد شهروندان در ا ع	رسیده به ایراناینترنشنال نشان میدهد شهروندان در اعتر اض به ماجراجویی سپاه پاسداران جملاتی چون سپاه ملت ایران را قربانی حم اس و حزب الله میکند و ماجراجویی موشکی سپاه، ممنوعالخروجی ما در پ ادگان را در تهران دیوارنویسی کردهاند		
سفرهای پی درپی مقامهای جمهوری اسلامی به لبنان واکنشهای گستر	گسترده ای را در این کشور به دنبال داشته است بسیاری از لبنانیها جمهوری اسلامی را متهم میکنند که راه این کشور را برای به دست گرفتن ابتکار عمل سیاسی و رسیدن به آتشبس سد کرده است میفرحات، ایران اینترنشنال گزارش میدهد		
نیامینا، با یک	امینا، با یک دسته پهپاد انجام شده است گزض افه کرد ، پهپاد مدل مرصاد الد ک ایوه ول ول شول ش      ا ای ت جگ میال الائیل و زالله لولا		
درپی موج جدید و گستردهی تحریمهای اتحادیه و بریتانیا عل یه جم	درپی موج ج و گ گردهی تری اتاتای اوپا وریالی جمهو الا ای مقامهای  پاه پارا و و و وزارت فر فهر تریم قرار گرفوگوگوگوگو وریا اشی ایوو		
ه اهدافی مطرح شد	هدافی مطرح شده و چه تاثیری بر سیاستها و اقدامات جمهوری اسلامی دارن		
را در فهرست تحری	در فهرست تحریمهای این اتحادیه قرار دادگفتوگو با نیلوفر پورابراه یم و علی حسنپور، ایران اینترنشنال		
کعبی، عضو مجلس خبرگان در خصوص کیفیت کمکرسانی به جهاد در غز ه	کعبی، عضو مجلس خبرگان در خصوص کیفیت کمکرسانی به جهاد در و گفت هرکس کاری از دستش بر میآید باید انجام دهداو افزود د اقتصادی و پشتیبانی مالی، رسانهای و اقتصادی، کمک به مجروحان و  یم		
خبرگزاری مهر خبر داده به دلیل ناامنی و احتمال جنگ، تعدادی	حتمال جنگ، تعدادی از بازیکنان خارجی لیگ برتر بسکتبال ایران، قرارداد خود را فسخ و ایران را ترک کردهاند پیش از این فرانسه به همین دلیل ا ز فوتبالیستهای شاغل در ایران ال		
جهانپهلوان رسول خادم، قهرمان کشتی جهان، وریا غفوری، کاپیت	ن، وریا غفوری، کاپیتان پیشین استقلال و پرویز پرستویی، بازیگر، مردم زلزلهزده این شهر دیدار کردند در ۲۹ خرداد ۱۴۰۳، زلزلهای به قدرت ۵ ریشتر کاشمر را لرزاند و خسارت زیادی به خانههای روستایی وارد کرد اسلامی، هنوز بسیاری از مردم روستاهای مانند زندهجان، کسرینه و محمدیه در چادر به سر میبرند سانههای ایران خبر دادهاند با وجود نزدیک بودن فصل سرما، روند بازس ازی خانههای تخریبشده و آسیبدیده با کندی پیش میرود طرفدارے ر، نوشته است نبود سرپناه مناسب، مشکلات بهداشتی وکمبود امکانات اولی ه از جمله چالشهایی است که این روزها مردم زلزلهزده کاشمر با آن دست وپنجه نرم میکنندرسول خادم در سالهای گذشته در قالب خیریهای و همراه با برخی ورزشکاران و هنرمند    کمکرسانی کرده است		
امروز در برنامه با کامبیز حسینی از قتل داریوش مهرجویی و وحید	امروز در برنامه با کامبیز حسینی از قتل داریوش مهرجویی و وحیده محمد یفر خواهیم گفت یکسال پس از این قتل فجیع، پرونده هنوز در جریان است وکیل خانوادهی مهرجویی میگوید قتل بدون آمر غیرممکن بوده است همزمان بسیاری معتقدند قتل داریوش مهرجویی و همینطور خودکشی مشکوک کیومرث پوراحمد در ادامهی قتلهای حکومتی روشنفکران بوده است و محمدیفر نفع میبرای شرکت در برنامه به واتساپ و تلگرام ما ام بفرستید تا لینک شرکت برایتان ارسال شود تلفن برنامه ۰۰۴۴۷۵۱۰۱۱۰۱۱۰		
مسعود کیمیایی، کارگردان و نویسنده در سالگرد قتل داریوش مهرجویی	د کیمیایی، کا و  دویر  ققوشوش مهرجویی و ویه  ی ض  ض و وض د  گ گ گ گ گ گ گ گ گ گگ  یچ جوا ی مرگ او و و و ش  ال کی یی یی یای ایرا   ما و و ازود  من زندهام مگر این سینما زنده است جواب این مردنها را چه کسی میدهد آیا سینما همینی استکه هست مردهایی که بهجای زنها میرقصند		
مجلس که در اجلا	امیرحول ثا ف   یج دالشجویی و  ف فهرا ج دل اجلا اتایه یالمجال   ود ، وه بلیل  مترجم فاوه وه الگلی و ای اادر    وهت ص ص ص ص  ز الگلی ،  ص  شش رش ادامه دهد و سخنرانی او نیمهکاره قطع شد		
جهانپهلوان رسول خادم، قهرمان کشتی جهان، وریا غفوری، کاپیت	ن، وریا غفوری، کاپیتان پیشین استقلال و پرویز پرستویی، بازیگر، مردم زلزلهزده این شهر دیدار کردند در ۲۹ خرداد ۱۴۰۳، زلزلهای به قدرت ۵ ریشتر کاشمر را لرزاند و خسارت زیادی به خانههای روستایی وارد کرد اسلامی، هنوز بسیاری از مردم روستاهای مانند زندهجان، کسرینه و محمدیه در چادر به سر میبرند سانههای ایران خبر دادهاند با وجود نزدیک بودن فصل سرما، روند بازس ازی خانههای تخریبشده و آسیبدیده با کندی پیش میرود طرفدارے ر، نوشته است نبود سرپناه مناسب، مشکلات بهداشتی وکمبود امکانات اولی ه از جمله چالشهایی است که این روزها مردم زلزلهزده کاشمر با آن دست وپنجه نرم میکنندرسول خادم در سالهای گذشته در قالب خیریهای و همراه با برخی ورزشکاران و هنرمند    کمکرسانی کرده است		
محسن اراکی، عضو مجلس خبرگان گفت جامعه روحانیت باید در میان م	مح اکی، ومجل خگال گ ججا ی وومیال د و ورای مردم تلاش ک ت جالا ی س ق داد  ازود ججا حالی ول در مقا و   مرد  زیرا   از ز از جامعه و درکنار جامعه است		
جزئیات پیام کارگردان برجسته سینمای ایران در سالگرد قتل داریوش	جزئیات پیام کارگردان برجسته سینمای ایران در سالگرد قتل داریوش مهرج کیمیایی از مرگ سینمای ایران گفت و از بی توجهی جا یگاه زنان در سینما انتقاد کردگفتوگو با امید کشتکار، ایران اینترنش نال		
رادیو ارتش اسرائیل درباره استفاده حزبالله از ماهواره جمهوری ا	می برای حمله پهپادی به اسرائیل گزارش داد رسانههای لبنان میگویند، سپاه پاسداران، فرماندهی مستقیم نیروها ی حزبالله را برعهده گرفته استگفتوگو با علیحسین قاضیزاده، ایر ان اینترنشنال		
مهوری اسلامی را	دولت بالیا دوش  ۲۳ م ت مق و  و و  وا جمهوری ا در فه  خود قود الا  ک  اشخاص و  د یی که دایی یا ح ح ی وراد ذک داو ، ه آ آ دارایی  کرده از ه  کنند		
صحبتهای سخنگوی دولت اسرائیل در یک کنفرانس خبری دیوید منسر ه	صحبتهای سخنگوی دولت اسرائیل در یک کنفرانس خبریدیوید منسر هر کشو ری از هر جبههای به اسرائیل حمله کند بهای گزافی میپردازد		
پانزده کشور م	جواد عزتی، بازیگر سینما، با بیان اینکه امکان ندارد شما فهرستی از پا ت معتقدم سینمای ما در زمینه بازیگری در سطح اول دنیا قرار دارد و اصلا در این زمینه شکی وجود ندارد		
سرخط خبرهای دوشنبه ۲۳ مهر	سرخط خبرهای دوشنبه ۲۳ مهر		
ع فیلترینگ اینت	فاطمه مهاجرای،  دوی پزشکیالت ، ، پا و سوالی خصوص وص وص وص وصگ ای و ایک  آیای ظ ج  یگ ود ، گ گ گ گ  غیی غیی رات		
تیرگی روابط روسیه با غرب گفتوگو با کیمیا قربانی و علی حسنپور	تیرگی روابط روسیه با غربگفتوگو با کیمیا قربانی و علی حسنپور، خب		
این منطقه، مقا	گروهی از اهالی طرقرود نطنز در اعتراض به فعالیت غیراصولی معادن ای ن منطقه، مقابل وزارت صنعت و معدن تجمع کردند میگویند فعالیت معادن به تخریب گسترده کرکس کوه نطنز منجر ش		
بنابر گزارشها، در پی افزایش تنش میان جمهوری اسلامی و اسرائیل،	گزارشها ، پی پی ازایش تش میال جمهوری الامی و الائی ، قیمت قی ب آزاد ت  ۶۳ ۶۳ زار ۳۰۰ توم کوو   ی اولی ، قیمت ک طلای طرح جط د تاوهرا ب گذ گذ ی میول ، رکورد تاریخی جدیدی ثبتکرد		
کولایی، فعال اصلاحطلب به سایت رویداد۲۴ گفت روابط جمهوری اسل	تغییر قابل توجهی در آن راه یابداو افزود ما همواره کارت بازی روسیه د ر تنظیم رابطه با غرب بودهایم		
بررسی روزنامههای ایران، دوشنبه، ۲۳ مهر با محمد رهبر، ایر ان ا	بررسی روزنامههای امروز ایران، دوشنبه، ۲۳ مهر با محمد رهبر، ایران اینترنشنال		
اسکوربرد جدید ورزشگاه آزادی ۲۰ سال پس از بازی ایرانآلمان،	ز بازی ایرانآلمان، تعویض شد    اسکوربرد استادیوم آزادی ۷ متر عرض و ۱۹ متر طول دارد گفته شده رزولوشن این نمایشگر ۱۴۰ متر مربی، بیش از   است و به سیستم ص  و سکوربرد مشابه در ضلع جنوبی استادیوڅ شد		
ترکیه از پولهای اتحادیه اروپا برای اخراج مهاجران افغانستان س	ترکیه از پولهای اتحادیه اروپا برای اخراج مهاجران افغانستان و سور یه استفاده میکند مصدق پارسا، ایران اینترنشنال گزارش میدهد		
آکادمی نوبل، روز دوشنبه ۲۳ مهر جایزه نوبل اقتصادی سال ۲۰۲۴ را	آکاد ، روز دوش  ۲۳ م جایزایز ول اقای ۲۰۲۴ ورا مطالووگی شکلگی رو ولاوغلو ، ی ی جاول و جیمز رالا اهدا ک ک ک  آ آزرمی، ای		
عباس عراقچی، وزیر خارجه جمهوری اسلامیگفت روند تماس غیرمستقیم	عباس عراقچی، وزیر خارجه جمهوری اسلامی گفت روند تماس غیرمستقیم بین ایران و آمریکا از طریق مسقط در حال حاضر به دلیل شرایط خاص منطقه متوقف		
فرهنگستان زبان و ادب پارسی واژه گرایه را به جای ترِند پیش	ف زو ز و اد پاواژژ  در توضی ای الخاو گ گ  توولد ش  م ا  امری در کوتاه  علاق  م گرایه دقیقا به معنی ترند است یعنی مورد علاقه مردم و مشخصا در شبکه ها ی اجتماعی و فضای اجتماعی		
دو اسرائیلی به دلیل انجام اقدامات خرابکارانه برای جمهوری اسلام	برنامه ریزی برای کشتن یک شخصیت بلندپایه اسرائیلی دستگیر شدند اینترنشنال گزارش میدهد		
ایران به روسیه	ات این تحریمها میگوید		
دلیل ارسال موشک	ل ارسال موشک به روسیه به فهرست تحریمها اضردهمچنین شرکتهای سامد الکترونیک پویا، شرکت آلومینای ایران، مرکز تحقیقات حاج موحد و شرکت مهندسی تیف تدبیر، دیگر نهادهای تحریمشده از سوی اتحادیه اروپا هستند		
ایران به روسیه	ران به روسیه تحریم کردهمچنین این اتحادیه سه شرکت هواپیمایی ساها، ما هان و ایرانایر را به فهرست تحریمهای خود اضافه کرد		
مصطفی پورمحمدی، وزیر پیشین دادگستری و قائم مقام اسبق وزارت اطل	اطلاعات به شبکه خبر گفت سال گذشته ۲۰۰ عملیات جاسوسی و خرابکاری در داخلکشور کشف و خنثی شده است		
ژی ایران گفت بر	دران ایران گفت برقیسازی تهران مسیری برای کاهش مصرف در شهر تهران استاو افزود وجود گاز در شهر تهران با توجه به احتمالات طبیعی مانند زلزله رناک است و باید در بلندمدت حذف شود		
بر جای گذاشت حال	حملههای پهپادی و راکتی حزبالله به اسرائیل دهها کشته و زخمی بر جای گذاشت حال هشت تن از ۴۱ تن زخمی حمله پهپادی، وخیم گزارش شده است ساعتی پیش تعداد زیادی موشک از سوی حزبالله به سوی اسرائیل شلیک شدگ فتوگو با اشکان صفایی، ایراناینترنشنال		
مونا مهرجویتر داریوش مهرجویی و وحیده محمدیفر، همزمان با س الگ	موو جویی، خر داریوش   و ویه  ، ه ،  سالگ پرگذش و ماد وی ز اج مزا  کارگ را د قتل رسیدند		
هران از نظر ساز	ی زالی، ریی لوم پزشکی ب ش گ گ گ گ گ  ال ی تهرا از  و ایملی   ی مواجولی  ت ت     ی گوی گ قرار دار ک		
الله پس از مواج	محسن رضایی، فرمانده پیشین سپاه پاسداران در شبکه ایکس نوشت حزبالل ه پس از مواجهه با موجی از ترورها، سازمان رزمی خود را ترمیم کرده و ون ماشین جنگی حزبالله راه افتاده و روزهای سختی در انتظار اسرائیلی هاست		
یکی از پهپادهای شلیک شده از سوی حزبالله بعد از شناسایی توسط س	یکی پ پهپاد شلیک ش ز س ز ز ز الله ش ش ا تو  داولائی ، ن ن ، ن   اود را کاد اداز  ای راداری محو شه ا این پهپاد به سقف یک سالن غذاخوری یک پادگان در شمال اسرائیل برخورد ک ردگفتوگو با اشکان صفایی، ایراناینترنشنال		
معبد آپولو در غرب ترکیه یکی از مهمترین مراکز مذهبی یونان باست	معبد آپولو در غرب ترکیه یکی از مهمترین مراکز مذهبی یونان باستان ب وده که کارشناسان، درجه اهمیت آن را با کعبه امروزی مقایسه میکنندگزا رش فرزیا ثابتی، ایراناینترنشنال		
جایزه ویژه هیات داوران جشنواره پرتقال طلایی آنتالیا به فیلم شا	جایزه ویژه هیات داوران جشنواره پرتقال طلایی آنتالیا به فیلم شاهد ا هدا شد این فیلم ساخته نادر ساعیور و بازی هانا کامکار، مریم بوبانی و غزل ش جاعی بدون رعایت قوانین سانسور جمهوریاسلامی ساخته شده استگفتوگو با نرگس هورخش، ایراناینترنشنال		
یقات راه، مسکن و	ی ویاللهی، ریی  زلزلهش د و خطرپذی م تات ،ک ش  حود ۱۰۰ ولد  قیقا و  گ ف  شه ا او ازود ای  و سازها اغلب در منطقه یک بوده و مابقی مربوط به منطقه ۲۲ است		
سرخط خبرهای دوشنبه ۲۳ مهر	سرخط خبرهای دوشنبه ۲۳ مهر		
درپی واکنشهای گسترده به حمله احتمالی اسرائیل به ایران، رسانه	د ر ر  موشکی ض تاد در الائیل ، بر  وم  و توام دوریری رو  میش ی، ایرا الو شال گزارش می		
سفر منطقهای عراقچی، وزیر خارجه جمهوریاسلامی گفتوگو با علیح	سفر منطقهای عباس عراقچی، وزیر خارجه جمهوریاسلامیگفتوگو با عل یحسین قاضیزاده، ایراناینترنشنال		
درحالی خاتون بم به جمع ۸ تیم برتر آسیا صعود کرد که افتادن	عود کرد که افتادن روسری زهرا قنبری در هنگام شادی گل به حاشیه پررنگی دل شد و این موفقیت را تحت تاثیر قرار دادگفتگوی مزدک میرزایی با پوربخش و محمد تقوی مشروح برنامه هتتریک را اینجا ببینید		
صعود تاریخی تیم فوتبال زنان خاتون بم به جمع ۸ تیم برتر لیگ	جمع ۸ تیم برتر لیگ قهرمانان آسیا، شایستگیهای این تیم را نشان داد گفتگو با معصومه حسرتی، بازیکن پیشین تیم ملی و باشگاه ملوانمشروح ب رنامه هتتریک را اینجا ببینید		
در پی یک حمله پهپادی از سوی حزبالله لبنان به شهر بنیامینا در	مرکزی اسرائیل، چهار تن کشته و دستکم ۶۷ تن مجروح شدندگفتوگو بشک ان صفایی، ایراناینترنشنال		
آرمین سهرابیان، بازیکن نساجی مازندران درگفتگویی با فوتبال	ایرال ایشورزشیآ ورزشیآ  ، ب   مر بویی ویی بوتال ۳۶۰، دویوی جوی جوی ج گ گ الی و شیطالپی، ای صویر  ، چرا چیزی میگویید که فضای مجازی را بترکانداو ضمن اینکه مدعی شد فسخ قراردادش با استقلال ربطی به این تتو نداشته است، گفت که تتو را پا ک نمیکند احتمالا آنرا بپوشاند		
علیرضا کاظمیر آموزش و پرورش گفت وجود مدارس کانکسی به معنای ب	ی کاظ آموزش ا پورش گ گ ود مداوه    ح ورا  ت شرایط اقلی و گاهی تادوز  ایجاد  کاو میالجامد  ازود گاهی اوق ای ک قط یک قط قط  یگ جابهجا میکنند و با خود میبرند		
اه و انقلابی ک	ردانی کرده و با تحسین آنها نوشت ارزش این هبه زنانه را نباید تنها کمک مادی خلاصه کرد، این گذشت مادی حتی فراتر از ارزش زیبایی و زینتی است		
آخرین تحولات غزه، لبنان	ملل		
اولف کریسترسون، نخستوزیر سوئد از اتحادیه اروپا خواست سپاه پاس	کریسترسون، نخستوزیر سوئد از اتحادیه اروپا خواست سپاه پاسدار ان را در فهرست سازمان تروریستی قرار دهد  پالارا		
یکی از مخاطبان ایران اینترنشنال از کانادا از محمد تقوی پرس	دا از محمد تقوی پرسیده است که آیا امیر قلعهنویی شایستگی مربیگری یم ملی فوتبال ایران را دارد و چگونه میخواهد تیم ملی را به جام جهانی ببرداز تقوی بپرس بخش طبان ایران اینترشنال از محمد تقوی میپردازد با ارسال پیامهای متنی، و ویدئویی به پیامگیرهای ما میتو انید هر سوالی که درباره فوتبال دارید را از محمد تقوی بپرسیدسوالات م و یا سیگنال ۰۰۴۴۷۸۳۰۰۰۷۰۰۰ بفرستید لطفاً هنگام ضبط ویدیو، دوربین خود را به صورت اگیریدمشروح برنامه هتتریک را اینجا ببینیدازتقویبپرس		
امیر قلعهنویی، سرمربی تیم ملی درحالی مدعی جوانگرایی است	ایرال ایشو ورزشیا ق س س ی دوت   و یا آ  بوضیات  پ ایرال ایشو   ه		
یکی از کابوسهای سالهای اخیر تیم ملی فوتبال ایران در بازی	کابوسهای سالهای اخیر تیم ملی اکر، ن است محمد تقوی، ایران اینترنشنال معتقد است مدافعان تیم ملی باید با دفاع اکرم عفیف را از بازی خارج کنندمشروح برنامه هتتریک را ینجا ببینید		
شهناز کاملزا	از کاملزاده، ایراناینترنشنال		
روزنامه اعتماد وضعیت آب در تهران از زنگ خطر یا هشدار خشکسالی	روزوز اوماد وضی آ تهرا از ز یا  خشک خشک فر ا ی آای ی    اوه توا از   زیرزی ورداش ک ایمگگوگوگو  ،وث ، تلیلگ ح آ زی		